,0,1,2,3,4,5,6,7,8,9,10,11,12,13,14,15,16,17,18,19,20,21,22,23,24,25,26,27,28,29,30,31,32,33,34,35,36,37,38,39
0,2,2,2,2,2,2,2,2,2,1,1,1,1,1,1,0,0,0,0,0,1,1,1,1,1,1,1,0,0,1,1,1,1,1,1,1,1,1,1,1
1,2,2,2,2,2,2,2,2,1,1,1,1,1,1,1,0,0,0,0,0,1,1,1,1,1,1,0,0,0,1,1,0,0,0,1,2,2,2,1,1
2,2,2,2,2,2,2,2,2,1,1,1,1,1,1,1,1,1,0,0,1,1,1,1,2,2,2,0,0,0,0,0,0,0,0,0,2,2,2,2,2
3,2,2,2,2,2,2,2,2,1,1,0,0,0,0,1,1,1,1,1,1,2,2,2,2,2,2,2,2,2,0,0,0,0,0,0,2,2,2,2,2
4,2,2,2,2,2,2,2,2,1,1,0,0,0,0,1,1,1,1,1,2,2,2,2,2,2,2,2,2,2,0,0,0,1,2,2,2,2,2,2,2
5,2,2,2,2,2,2,2,2,1,1,0,0,0,0,0,1,1,1,1,2,2,2,2,2,2,2,2,2,0,0,0,1,1,2,2,2,2,2,2,1
6,2,2,2,2,2,2,2,2,1,0,0,0,0,0,0,0,0,1,1,2,2,2,2,2,2,2,2,2,2,0,0,1,1,2,2,2,2,2,2,2
7,1,1,1,1,1,1,1,1,1,0,0,0,0,0,0,0,0,0,0,0,0,2,2,2,2,2,2,2,2,2,1,0,0,0,2,2,2,2,2,2
8,0,1,1,1,1,1,1,1,1,0,0,0,0,0,0,0,0,0,0,0,0,0,2,2,2,2,2,2,2,2,1,1,0,1,1,1,1,1,1,1
9,0,1,1,1,1,1,1,1,0,0,0,0,0,0,0,0,0,0,0,0,0,2,2,2,2,2,2,2,2,2,1,1,1,1,1,1,1,1,1,1
10,0,0,1,1,1,1,1,0,0,0,0,0,0,0,1,1,1,1,0,0,2,2,2,2,2,2,2,2,2,2,1,1,1,1,1,1,1,1,1,1
11,0,0,1,1,1,0,0,0,0,0,0,0,0,1,1,1,1,1,1,2,2,2,2,2,2,2,2,2,2,2,1,1,1,1,1,1,1,1,1,0
12,0,0,0,0,0,0,0,0,0,0,0,0,0,0,1,0,1,1,1,2,2,2,2,2,2,2,2,2,2,2,1,1,1,1,1,1,1,1,0,0
13,0,0,0,0,0,0,0,0,0,0,0,0,0,0,0,0,0,0,1,2,2,2,2,2,2,2,2,2,2,1,1,1,1,2,2,2,1,1,0,0
14,0,0,1,1,0,0,0,0,0,0,0,0,0,0,0,0,0,0,0,1,1,1,1,1,1,1,1,1,1,1,1,2,2,2,2,2,2,1,0,0
15,0,0,1,1,1,1,0,0,0,1,1,1,2,1,1,1,0,0,0,1,1,1,1,1,1,1,1,1,1,1,1,2,2,2,2,2,2,2,1,1
16,0,1,1,1,1,1,1,0,1,1,1,1,1,1,1,1,1,1,1,1,1,1,1,1,1,1,1,1,1,1,1,2,2,2,2,2,2,2,1,1
17,0,1,1,1,1,1,1,2,1,1,1,1,1,1,1,1,1,1,1,1,0,0,1,1,1,1,1,1,1,1,2,2,2,2,2,2,2,2,1,1
18,1,1,1,1,1,1,1,1,1,1,1,1,1,1,1,1,1,1,1,0,0,0,1,1,1,1,1,1,2,2,2,2,2,2,2,2,2,2,1,1
19,1,1,1,1,1,1,1,1,1,1,1,1,1,1,1,1,1,1,1,0,0,0,1,1,1,1,1,1,1,2,2,2,2,2,2,2,2,1,1,1
20,1,1,1,1,1,2,2,2,2,2,2,2,2,2,2,2,1,1,1,0,0,0,1,1,1,1,1,1,2,2,2,2,2,2,2,1,1,1,1,1
21,1,1,1,0,1,2,2,2,2,2,2,2,2,2,2,2,2,1,0,0,0,0,0,1,1,1,1,1,2,2,2,2,2,2,2,1,1,0,0,0
22,1,1,0,0,0,0,2,2,2,2,2,2,2,2,2,2,2,1,0,0,0,0,0,1,1,1,1,1,1,2,2,2,2,2,2,2,1,0,0,1
23,0,0,0,0,0,0,0,2,2,2,2,2,2,2,2,2,2,2,0,0,0,0,1,1,1,1,1,1,1,2,2,2,2,2,2,2,0,0,0,1
24,0,0,0,0,0,0,0,0,0,2,2,2,2,2,2,2,2,2,0,0,0,0,1,1,1,1,1,1,1,2,2,2,2,2,2,2,1,0,1,1
25,0,0,0,0,0,0,0,0,0,0,2,2,2,2,2,2,2,2,0,1,1,2,1,1,2,1,1,1,1,2,2,2,2,2,2,1,1,1,1,1
26,0,0,0,0,0,0,0,0,2,2,2,2,2,2,2,2,2,2,1,1,2,2,2,2,2,2,1,1,2,2,2,2,2,2,2,1,1,1,1,1
27,0,0,0,0,0,0,0,0,2,2,2,2,2,2,2,2,2,2,1,1,2,2,2,2,2,2,1,1,2,2,2,2,2,2,1,0,0,0,1,1
28,0,0,0,0,0,0,0,0,2,2,2,2,2,2,2,2,2,2,1,2,2,2,2,2,2,2,1,1,2,2,2,2,2,2,0,0,0,1,1,1
29,0,0,0,0,0,2,2,2,2,2,2,2,2,2,2,2,2,2,1,1,2,2,2,2,2,2,1,1,2,2,2,2,2,0,0,0,0,1,1,1
30,2,2,2,2,2,2,2,2,2,2,2,2,2,2,0,2,2,2,1,2,2,2,2,0,0,0,1,1,2,2,2,2,2,2,0,0,0,1,1,1
31,2,2,2,2,2,2,2,2,2,2,2,2,2,2,0,0,0,0,1,1,2,2,2,2,0,1,1,1,1,2,2,2,2,2,0,0,1,1,1,1
32,2,2,2,2,2,2,2,2,2,2,2,2,2,2,0,0,0,0,1,1,2,2,2,2,2,1,1,1,1,1,1,1,1,1,0,1,1,1,1,1
33,2,2,2,2,2,2,2,2,2,2,2,2,2,2,2,0,0,0,1,2,2,2,2,2,2,2,1,1,1,1,1,1,1,0,0,0,1,1,1,1
34,1,2,2,2,2,2,2,2,2,2,2,2,2,2,2,0,0,0,0,2,2,2,2,2,2,1,1,1,1,1,1,1,1,0,0,0,1,1,1,1
35,1,2,2,2,2,2,2,2,2,2,2,2,0,0,0,0,0,0,0,2,2,2,2,2,2,1,1,1,1,1,1,2,2,2,2,2,1,1,1,1
36,2,2,2,2,2,2,2,2,2,2,0,0,0,0,0,0,0,0,0,0,2,2,2,2,2,1,1,1,1,1,1,2,2,2,2,2,1,1,1,1
37,2,2,2,2,2,2,2,0,0,0,0,0,0,0,0,0,0,0,0,0,0,0,0,0,0,0,1,1,1,1,1,2,2,2,2,2,2,2,1,1
38,2,2,2,2,2,2,2,2,0,0,0,0,0,0,0,1,1,0,0,0,0,0,0,0,0,1,1,1,1,1,1,2,2,2,2,2,2,1,1,1
39,1,2,2,2,2,2,2,0,0,0,0,0,0,0,1,1,1,1,0,0,0,0,0,0,1,1,1,1,1,1,1,2,2,2,2,2,2,1,1,1
