,0,1,2,3,4,5,6,7,8,9,10,11,12,13,14,15,16,17,18,19,20,21,22,23,24,25,26,27,28,29,30,31,32,33,34,35,36,37,38,39
0,1,1,1,1,1,1,1,1,1,1,1,1,1,1,1,2,2,2,2,2,2,2,2,2,2,2,2,2,2,2,2,2,1,1,1,1,1,1,1,1
1,1,1,1,1,1,1,1,1,1,1,1,1,1,1,1,2,2,2,2,2,2,2,2,2,2,2,2,2,2,2,2,2,1,1,1,1,1,1,1,1
2,1,1,1,1,1,1,1,1,1,1,1,1,1,1,1,2,2,2,2,2,2,2,2,2,2,2,2,2,2,2,2,2,1,1,1,1,1,1,1,1
3,1,1,1,1,1,1,1,1,1,1,1,1,1,1,1,2,2,2,2,2,0,2,2,2,2,2,2,2,2,2,2,2,1,1,1,1,1,1,1,1
4,2,2,2,1,1,1,1,1,1,1,0,1,1,1,2,2,2,2,0,0,0,2,2,2,2,2,2,2,2,2,2,2,1,1,1,1,1,0,0,0
5,2,2,2,2,1,1,1,1,1,0,0,0,1,1,2,2,2,2,0,0,0,0,2,2,2,2,2,2,2,2,2,2,1,1,1,1,0,0,0,0
6,2,2,2,2,1,1,1,1,1,0,0,0,0,0,2,2,2,2,2,0,0,2,2,2,2,2,2,2,2,2,2,2,1,1,1,1,1,1,0,0
7,2,2,2,2,1,1,1,1,1,1,0,0,0,0,0,2,2,2,2,2,0,2,2,2,2,2,2,2,2,2,2,2,1,1,1,1,1,1,1,1
8,2,2,2,1,1,1,1,1,1,1,0,0,0,0,0,0,2,2,2,2,2,2,2,2,2,2,2,2,2,2,2,2,1,1,1,1,1,1,1,1
9,2,2,2,1,1,1,1,1,1,1,1,0,0,0,0,0,2,2,2,2,2,2,2,2,2,2,2,2,2,2,2,1,1,1,1,1,1,1,1,1
10,1,1,1,1,1,2,2,1,1,1,1,2,2,2,0,0,2,2,2,2,2,2,2,2,2,2,2,2,2,2,2,1,1,1,1,1,1,1,1,1
11,1,2,2,2,2,2,1,1,1,1,1,2,2,2,2,2,2,2,2,2,2,2,2,2,2,2,2,2,2,2,2,1,1,1,1,1,1,1,1,1
12,1,2,2,2,2,2,1,1,1,1,1,2,2,2,2,2,2,2,2,2,2,2,2,2,0,2,2,2,2,2,2,1,1,1,1,1,1,1,1,1
13,1,2,2,2,0,0,0,1,1,1,2,2,2,2,2,2,2,2,2,2,2,2,2,0,0,0,0,2,2,2,1,1,1,1,1,1,1,1,1,1
14,1,2,2,0,0,0,0,1,1,1,1,2,2,2,2,2,2,2,2,2,2,2,2,0,0,0,0,0,0,0,0,1,1,1,1,1,1,1,1,1
15,0,0,0,2,0,0,0,1,1,1,2,2,2,2,2,2,2,2,1,1,1,1,1,1,0,0,0,0,0,0,0,1,1,1,1,1,1,1,1,1
16,0,0,0,1,1,1,1,1,1,1,1,1,2,0,0,0,0,1,0,0,1,1,1,0,0,1,1,0,0,0,0,1,1,1,1,0,0,0,0,1
17,0,0,1,1,1,1,1,1,1,1,1,1,1,1,0,0,0,0,0,0,0,0,0,0,0,1,1,0,0,0,0,1,1,1,1,0,0,0,1,1
18,0,0,1,1,1,1,1,1,1,1,1,1,1,1,1,1,1,0,0,0,0,0,0,0,0,1,1,1,0,0,2,1,1,1,1,1,0,0,1,1
19,0,0,0,1,1,1,1,1,1,1,1,1,1,1,1,1,1,0,0,0,0,0,0,0,0,1,1,2,2,2,2,2,1,1,1,1,1,1,1,1
20,0,0,0,0,1,1,1,1,1,1,1,2,2,2,1,1,0,0,0,1,1,0,0,0,0,0,1,2,2,2,2,2,1,1,1,1,1,1,1,1
21,0,0,0,0,0,1,1,0,0,0,0,0,2,2,2,2,0,0,0,1,1,1,1,0,0,0,0,0,2,2,2,2,1,1,1,1,1,1,1,1
22,0,0,0,0,0,1,1,0,0,0,0,2,2,2,2,2,2,1,1,1,2,2,2,2,0,0,0,0,0,2,2,2,1,1,1,1,1,1,1,1
23,0,0,0,0,0,1,1,0,0,0,0,2,2,2,2,2,2,1,1,1,2,2,2,2,2,0,0,0,0,2,2,2,1,1,1,1,1,1,1,1
24,0,0,0,0,0,0,0,0,0,0,0,2,2,2,2,2,2,1,1,1,2,2,2,2,2,2,0,0,1,1,1,1,1,1,1,1,1,1,1,1
25,0,0,0,0,0,0,0,0,0,0,0,2,2,2,2,2,2,1,1,0,0,0,2,2,2,2,2,2,1,1,1,1,1,1,1,1,1,1,1,1
26,0,0,0,0,0,0,0,0,0,0,0,2,2,2,0,0,0,0,0,0,0,0,2,2,2,2,2,2,2,1,1,1,1,1,1,1,1,1,1,1
27,0,0,0,0,0,0,0,1,0,0,0,1,1,0,0,0,0,0,0,0,0,0,2,2,2,2,2,2,2,1,1,1,1,1,1,1,1,1,1,1
28,0,0,1,1,1,0,0,1,1,0,1,0,0,0,0,0,0,0,0,0,0,0,2,2,2,2,2,2,1,1,1,1,1,1,1,1,1,1,1,1
29,0,0,0,1,1,0,0,1,1,1,1,1,0,0,0,0,0,0,0,1,0,0,2,2,2,2,2,2,2,1,1,0,0,0,1,1,1,1,1,1
30,0,0,0,1,0,1,1,1,1,1,1,1,0,1,1,1,1,1,1,1,1,1,1,1,1,2,1,1,1,1,1,0,0,0,1,1,1,1,1,1
31,2,0,0,0,0,1,1,1,1,1,1,1,1,1,1,1,1,1,1,1,1,1,1,1,1,1,1,1,1,1,1,0,0,1,1,1,1,1,1,1
32,2,2,0,0,0,0,1,1,1,1,1,1,1,1,1,1,1,1,1,1,1,1,1,1,1,1,1,1,1,1,1,1,1,1,1,1,1,1,1,1
33,2,2,2,2,0,2,2,1,1,1,1,1,1,0,0,0,0,1,1,0,0,1,1,1,1,1,1,1,1,1,1,1,1,1,1,1,1,1,1,1
34,2,2,2,2,2,2,2,1,1,1,1,0,0,0,0,0,0,0,0,0,0,0,1,1,1,1,1,1,1,1,1,1,1,1,1,1,1,1,1,1
35,2,2,2,2,2,2,2,0,1,1,1,0,0,0,0,0,0,1,0,0,0,0,1,1,1,1,1,1,1,1,1,1,1,1,1,1,1,1,1,1
36,2,2,2,2,2,2,0,0,0,0,0,0,0,0,0,0,1,1,1,0,0,0,0,1,1,1,1,1,1,1,1,1,1,1,1,1,1,1,1,1
37,2,2,2,2,2,2,1,0,0,0,0,0,0,0,0,0,1,1,1,0,0,0,1,1,1,1,1,1,1,0,0,1,1,1,1,1,1,1,1,1
38,0,1,1,1,1,1,1,1,0,0,0,0,0,0,0,0,0,1,1,1,1,1,1,1,1,1,1,1,0,0,0,1,1,1,1,1,0,0,0,1
39,0,0,1,1,1,1,1,1,0,0,0,0,0,0,0,0,0,1,1,1,1,1,1,1,0,0,0,0,0,0,1,1,1,1,1,0,0,0,0,1
