,0,1,2,3,4,5,6,7,8,9,10,11,12,13,14,15,16,17,18,19,20,21,22,23,24,25,26,27,28,29,30,31,32,33,34,35,36,37,38,39
0,1,1,1,1,1,1,1,0,0,0,0,1,1,1,1,1,1,1,0,0,0,1,1,1,1,1,1,1,1,1,1,1,1,2,2,2,2,2,2,2
1,1,1,1,1,1,1,1,1,0,0,0,1,1,1,1,1,1,1,0,0,0,0,1,1,1,1,1,2,2,2,2,2,2,2,2,2,2,2,2,2
2,1,1,1,1,1,1,1,1,0,0,1,1,1,1,1,1,1,1,1,0,0,1,1,1,1,1,2,2,2,2,2,2,1,2,2,2,2,2,2,2
3,1,1,1,1,1,1,1,1,1,1,1,1,1,1,1,1,1,1,1,1,1,1,1,1,1,1,2,2,2,2,2,0,0,0,0,2,2,2,2,1
4,0,1,1,0,0,0,1,1,1,1,1,1,1,1,1,1,1,1,1,1,1,1,1,1,1,1,2,2,2,2,2,0,0,0,0,0,1,1,1,1
5,0,0,0,0,0,0,0,1,1,1,1,1,1,1,1,1,1,1,1,1,1,1,1,1,1,1,2,2,2,2,2,2,0,0,0,0,0,1,1,1
6,0,0,0,0,0,0,1,1,1,1,1,1,1,1,1,0,0,0,1,1,1,1,0,0,0,1,2,2,2,2,2,2,0,0,0,0,0,0,1,1
7,0,0,0,0,0,0,0,0,1,1,1,1,1,1,1,0,0,0,0,1,1,0,0,0,0,2,2,2,2,2,2,2,2,0,0,0,0,0,0,1
8,0,0,0,0,0,0,0,0,0,0,1,1,1,1,1,1,0,0,0,1,1,1,0,0,0,2,2,2,2,2,2,2,2,0,0,0,0,0,0,0
9,0,0,0,0,0,0,0,0,0,0,1,1,1,1,1,0,0,0,0,1,1,1,0,0,1,2,2,2,2,2,2,2,2,0,0,0,0,0,0,0
10,0,0,0,0,0,0,0,0,0,1,1,1,1,1,0,0,0,0,0,1,1,1,1,1,1,1,2,2,2,2,2,0,0,2,2,0,0,0,1,1
11,0,0,0,0,0,1,1,1,1,1,1,1,1,1,1,0,0,0,0,1,1,1,1,1,1,1,2,2,2,2,2,0,0,2,1,1,1,1,1,1
12,1,1,1,1,1,1,1,1,1,1,1,1,1,1,1,1,0,0,0,1,1,1,1,1,1,1,1,2,2,2,2,0,0,0,1,1,1,1,1,1
13,0,0,1,1,1,1,1,1,1,1,1,1,1,1,1,1,1,1,1,1,1,1,1,1,1,1,1,2,2,2,2,2,0,0,1,1,1,1,1,1
14,0,0,0,0,1,1,1,1,1,1,1,1,1,1,1,1,1,1,1,0,0,0,0,1,1,1,1,2,2,2,2,2,1,1,1,1,1,1,1,1
15,0,0,0,0,0,0,0,0,0,1,1,1,1,1,1,1,1,1,1,0,0,0,0,1,1,1,1,2,2,2,2,2,1,1,1,1,1,1,1,1
16,0,0,1,1,0,0,0,0,0,1,1,1,1,1,1,1,1,1,1,1,0,0,1,1,1,1,1,1,1,1,1,1,1,1,1,1,1,1,1,1
17,1,1,1,1,1,1,0,0,0,0,0,0,0,1,1,1,1,1,1,1,0,1,1,1,1,1,1,1,1,1,1,1,1,0,1,0,0,1,1,1
18,1,1,1,1,1,1,1,0,0,0,0,0,0,1,1,1,1,1,1,1,0,1,1,1,1,1,1,1,1,1,1,0,0,0,0,0,0,0,0,0
19,1,1,1,1,0,1,1,0,0,0,0,0,0,1,1,1,1,1,1,1,0,1,1,1,1,1,1,1,1,1,0,0,0,0,0,0,0,0,0,0
20,1,1,1,0,0,0,0,0,0,0,0,0,0,1,1,1,1,1,1,0,0,0,1,1,1,1,1,1,1,1,0,0,0,0,0,0,0,0,0,0
21,1,1,1,0,0,0,0,0,0,0,0,0,0,1,1,1,1,1,0,0,0,0,0,1,1,1,1,1,1,0,0,0,0,0,0,1,0,0,2,2
22,1,1,1,0,0,0,0,0,0,0,1,1,1,1,0,0,0,0,0,0,0,0,0,0,1,1,1,1,0,0,0,0,0,1,1,1,2,2,2,2
23,1,1,1,0,0,0,0,0,0,0,0,1,1,0,0,0,0,0,0,0,0,0,0,0,0,0,1,0,0,0,0,0,1,1,1,1,2,2,2,2
24,1,1,0,0,0,0,0,0,0,0,0,0,0,0,0,0,0,0,0,0,0,0,0,0,1,1,1,0,0,0,0,0,1,1,1,1,2,2,2,2
25,1,0,0,0,0,0,1,0,0,0,0,0,0,0,0,0,0,0,1,0,0,0,1,1,1,1,1,0,0,0,0,0,1,1,1,1,1,2,2,2
26,1,0,0,0,0,1,1,1,0,0,0,0,0,0,0,0,0,0,1,1,1,1,1,1,1,1,1,0,0,0,0,0,1,1,1,1,1,0,0,0
27,1,1,0,0,0,1,1,1,0,0,0,0,0,0,0,0,0,0,1,1,1,1,1,1,1,1,1,0,0,0,0,0,0,1,1,1,0,0,0,0
28,1,1,0,0,0,1,1,1,0,0,0,2,2,0,0,0,0,0,0,1,2,2,2,1,1,1,1,1,0,0,0,0,0,0,0,0,0,0,0,0
29,1,1,0,0,0,1,1,1,0,0,0,2,2,0,0,0,0,0,0,0,0,2,2,2,2,1,1,1,0,0,0,0,1,0,0,0,0,0,0,0
30,1,1,0,0,0,1,1,1,0,0,0,2,0,0,0,0,0,0,0,0,2,2,2,2,2,1,1,0,0,0,0,1,1,1,0,0,0,0,1,1
31,1,1,0,0,0,0,1,1,0,0,2,2,2,0,0,0,0,1,1,2,2,2,2,2,2,2,0,0,0,0,0,0,1,0,0,0,0,1,1,1
32,1,0,0,0,0,0,0,0,0,0,0,2,2,0,0,0,1,1,1,2,2,2,2,2,2,2,0,0,0,0,0,0,1,1,0,0,1,1,1,1
33,0,0,0,0,0,0,0,1,0,0,0,0,0,0,0,1,1,1,1,2,2,2,2,2,2,2,2,1,1,1,0,1,1,1,1,0,1,1,1,1
34,0,0,0,0,0,1,1,1,0,0,0,0,1,0,1,1,1,1,1,2,2,2,2,2,2,2,2,1,1,1,1,1,1,1,1,1,1,1,1,1
35,0,0,0,0,1,1,1,1,1,0,0,1,1,1,1,1,1,1,1,0,0,0,0,2,2,2,2,1,1,1,1,1,1,1,1,1,1,1,1,1
36,0,0,0,1,1,1,1,1,1,1,1,1,1,1,1,1,1,1,0,0,0,0,0,2,2,2,2,1,1,1,1,1,1,1,1,1,1,1,1,1
37,0,0,0,1,1,1,0,1,0,1,1,1,1,1,0,0,0,0,0,0,0,2,2,0,0,0,0,1,1,1,1,1,1,1,1,1,1,1,1,1
38,0,0,0,0,1,0,0,0,0,0,1,1,1,1,0,0,0,0,0,1,1,2,2,0,0,0,0,0,0,0,0,1,1,1,0,0,1,1,1,1
39,0,0,0,0,0,0,0,0,0,0,1,1,1,1,0,0,0,0,0,1,1,1,1,0,0,0,0,0,0,0,0,0,0,0,0,0,0,0,1,1
