,0,1,2,3,4,5,6,7,8,9,10,11,12,13,14,15,16,17,18,19,20,21,22,23,24,25,26,27,28,29,30,31,32,33,34,35,36,37,38,39
0,0,0,0,2,2,2,2,2,2,2,2,2,2,2,2,2,2,2,1,1,1,0,0,0,0,0,0,1,1,1,1,1,0,0,0,2,2,2,1,1
1,0,0,0,2,2,2,2,2,2,2,2,2,2,2,2,2,2,2,1,1,1,1,0,0,0,0,0,0,0,1,1,0,0,0,1,2,2,2,1,1
2,0,0,0,2,2,2,2,2,2,2,2,2,2,2,2,2,2,2,1,1,1,1,1,0,0,0,0,0,0,0,0,0,0,2,1,1,1,1,1,1
3,0,0,0,2,2,2,2,2,2,2,2,2,2,2,2,2,2,2,1,1,1,1,1,0,0,0,0,0,0,0,0,0,0,1,1,1,1,1,1,1
4,0,0,2,2,2,2,2,2,2,2,2,2,2,2,0,2,2,2,1,1,1,1,0,0,0,0,0,0,0,0,0,0,0,0,1,1,1,1,1,1
5,2,2,2,2,2,2,2,2,2,2,2,2,2,0,0,0,2,2,1,0,1,1,1,0,0,0,0,0,0,0,1,1,0,0,0,1,1,1,1,1
6,2,2,2,2,2,2,2,2,2,2,2,2,0,0,0,0,0,0,0,0,1,1,1,1,1,1,0,0,0,1,1,1,0,0,0,1,1,1,1,0
7,2,2,2,2,2,2,2,2,2,2,2,2,0,0,0,0,0,0,0,0,1,1,1,1,1,1,0,1,1,1,1,1,1,0,0,0,0,0,0,0
8,2,2,2,2,2,2,2,2,2,2,2,2,2,0,0,0,0,0,0,0,1,1,1,1,1,1,1,1,1,1,1,1,1,0,0,0,0,0,0,0
9,2,2,2,2,2,2,2,2,2,2,2,2,2,0,0,0,0,0,0,1,2,1,1,1,1,1,1,1,1,1,1,1,1,0,0,0,0,0,0,0
10,2,2,2,2,2,2,2,2,2,2,2,2,2,2,2,0,0,0,1,1,1,1,1,1,1,1,1,1,1,1,1,1,1,1,0,0,0,0,1,1
11,2,2,2,2,2,0,0,2,2,2,2,2,2,2,2,0,0,0,1,1,1,1,1,1,1,1,1,1,1,1,1,1,1,1,0,0,0,1,1,1
12,2,2,0,0,0,0,0,0,2,2,2,2,2,2,0,0,0,1,1,1,1,1,1,1,1,1,1,1,1,1,1,1,1,1,1,0,1,1,1,1
13,2,0,0,0,0,0,0,0,2,2,2,2,2,2,2,0,0,1,1,1,1,1,1,1,1,1,0,0,0,0,1,1,1,1,1,1,1,1,1,1
14,0,0,0,0,0,0,0,0,0,2,2,2,2,2,0,0,0,0,0,0,0,0,1,1,1,0,0,0,0,0,1,1,1,1,1,1,1,1,1,1
15,1,1,0,0,0,0,0,0,0,2,2,2,2,2,0,0,0,0,0,0,0,1,1,1,1,0,0,0,0,0,1,1,1,0,2,2,1,1,1,1
16,1,1,1,1,0,0,0,1,2,2,2,2,2,0,0,0,0,0,0,0,1,1,1,1,1,0,0,0,0,1,1,1,1,0,2,2,2,1,0,0
17,1,1,1,1,1,1,0,2,2,2,2,2,2,2,1,1,1,1,1,1,1,1,1,1,1,0,0,0,1,1,1,1,1,0,0,2,2,0,0,0
18,1,1,1,1,1,1,0,0,1,1,1,1,1,1,1,1,1,1,1,1,1,1,0,0,0,0,0,0,0,1,1,1,1,0,0,1,0,0,0,0
19,0,0,1,1,1,1,0,1,1,1,1,1,1,0,1,1,1,1,1,1,1,0,0,0,0,0,0,0,0,0,0,0,0,0,0,0,0,0,0,0
20,0,0,0,1,1,1,1,1,1,1,1,1,1,0,0,1,1,1,1,1,1,0,0,0,0,0,0,0,0,0,0,0,0,0,0,0,0,0,0,0
21,0,0,0,0,1,1,1,1,1,1,1,1,1,0,0,0,1,1,1,1,0,0,0,0,0,0,0,0,0,0,0,0,0,0,0,0,0,0,0,0
22,0,0,0,0,1,1,1,1,1,1,1,1,1,0,0,0,1,1,1,1,1,0,0,1,1,1,1,0,0,0,0,0,0,0,0,0,0,0,0,0
23,0,0,0,1,1,1,1,1,1,1,1,1,1,1,1,1,1,1,1,1,1,1,1,1,1,1,1,0,0,0,0,0,0,0,0,0,0,0,0,0
24,0,0,1,1,1,1,1,1,1,1,1,1,1,1,1,1,1,1,1,1,1,1,1,1,0,0,0,0,0,0,0,0,0,0,0,0,2,2,2,2
25,0,0,0,1,1,1,1,1,1,1,1,1,1,1,1,1,1,1,1,1,1,1,1,0,0,0,0,0,0,0,0,0,0,0,2,2,2,2,2,2
26,0,0,0,0,0,0,1,1,1,1,0,0,0,0,1,1,2,2,2,1,1,1,0,0,0,0,0,0,0,0,0,0,0,2,2,2,2,2,2,2
27,0,0,0,0,0,0,1,1,1,1,0,0,0,0,0,0,0,2,2,1,1,0,0,0,0,1,1,0,0,0,0,0,0,2,2,2,2,2,2,2
28,0,0,0,0,0,0,1,1,1,1,1,0,0,0,0,0,0,2,2,1,1,0,0,0,0,1,1,0,0,0,0,2,2,2,2,2,2,2,2,2
29,0,0,0,0,0,0,1,1,1,1,2,0,0,0,0,0,0,1,1,1,1,0,0,0,0,1,0,0,0,0,2,2,2,2,2,2,2,2,2,2
30,0,0,0,0,0,0,0,0,0,1,1,0,0,0,0,0,0,1,1,1,1,1,1,0,0,2,0,0,2,2,2,2,2,2,0,0,2,2,2,2
31,0,0,0,0,0,0,0,0,0,1,1,1,0,0,0,0,0,1,1,1,1,1,1,1,1,2,2,2,2,2,2,2,2,2,0,0,2,2,2,2
32,0,0,0,0,0,0,0,0,0,1,1,1,0,0,0,0,0,0,0,1,1,1,1,1,1,2,2,2,2,2,2,2,2,2,0,0,2,2,2,2
33,0,0,0,0,0,0,0,0,0,0,1,1,1,0,0,0,0,0,0,1,1,1,1,1,1,2,2,2,2,2,2,2,2,2,0,0,2,2,2,2
34,0,0,0,0,0,0,0,1,0,1,1,1,1,1,0,0,0,0,1,1,1,1,1,1,1,2,2,2,2,0,0,2,2,0,0,0,1,1,1,1
35,0,0,0,0,0,0,1,1,1,1,1,1,1,1,1,1,1,1,1,1,1,1,1,1,1,2,2,2,0,0,0,0,0,0,0,0,1,1,1,1
36,0,0,0,0,0,0,1,1,1,1,1,1,0,0,0,1,1,1,1,1,1,1,1,1,1,2,2,2,0,0,0,0,0,0,0,0,1,1,1,1
37,0,0,0,0,0,0,1,1,1,1,1,0,0,0,0,1,1,1,1,1,1,1,1,1,1,1,2,0,0,0,0,0,0,0,0,1,1,1,1,1
38,0,0,0,0,0,0,1,1,1,1,1,0,0,0,0,0,1,1,1,1,1,1,1,1,1,1,1,1,0,1,1,1,1,1,1,1,1,1,1,0
39,0,0,0,0,0,0,1,1,1,1,1,0,0,0,0,0,1,1,1,1,1,1,1,1,1,1,1,1,1,1,1,1,1,1,1,1,1,1,1,0
