,0,1,2,3,4,5,6,7,8,9,10,11,12,13,14,15,16,17,18,19,20,21,22,23,24,25,26,27,28,29,30,31,32,33,34,35,36,37,38,39
0,1,1,1,1,1,1,1,1,1,1,2,2,2,2,2,2,2,2,2,2,2,2,2,2,2,2,1,1,1,1,1,1,1,1,1,1,1,1,1,1
1,1,1,1,1,1,1,1,1,1,1,1,2,2,2,2,2,2,2,2,2,2,2,2,2,2,2,1,1,1,1,1,1,1,1,1,1,1,1,1,1
2,2,2,2,2,2,1,1,1,1,1,2,2,2,2,2,2,2,2,2,2,2,2,2,2,2,2,1,1,1,1,1,1,1,1,1,1,1,1,1,1
3,2,2,2,2,2,1,1,1,1,1,2,2,2,2,2,2,2,2,2,2,2,2,2,2,2,2,1,1,1,1,1,1,1,1,1,1,1,1,1,1
4,2,2,2,2,2,1,1,1,1,1,2,2,2,2,2,2,2,2,2,2,2,2,2,2,2,2,1,1,1,1,1,1,1,1,1,1,1,1,1,1
5,2,2,2,2,2,1,1,1,1,1,2,2,2,2,2,2,2,2,2,2,0,0,2,2,2,2,1,1,1,1,1,1,1,1,1,1,1,1,1,1
6,2,2,2,2,2,2,2,1,2,2,2,2,2,2,2,2,2,2,2,0,0,0,0,0,2,2,1,1,1,1,1,1,1,1,1,1,1,1,1,1
7,0,0,0,2,2,2,2,2,2,2,2,2,2,2,2,2,2,2,2,2,0,0,0,0,1,1,1,1,1,1,1,1,1,1,1,1,1,1,1,1
8,0,0,0,2,2,2,2,2,2,2,2,2,2,2,2,2,2,2,2,2,2,0,0,2,2,2,2,2,1,1,1,1,1,1,1,1,1,1,1,1
9,1,0,0,0,2,2,2,2,2,2,2,2,2,2,2,2,2,2,2,2,2,0,2,2,2,2,2,0,0,1,1,1,1,1,1,1,1,1,1,1
10,1,1,0,0,0,0,2,2,2,2,2,2,2,2,2,2,2,2,2,2,2,2,2,2,2,2,0,0,0,0,2,2,2,1,1,1,1,1,1,1
11,2,1,2,0,0,0,2,2,2,2,2,2,2,2,2,2,2,2,2,2,2,2,2,2,2,2,0,0,0,0,2,2,2,2,1,1,1,1,1,1
12,2,2,2,2,2,2,2,2,2,2,2,2,2,2,2,2,2,2,2,2,2,2,2,2,2,2,2,0,0,2,2,2,2,2,1,1,1,1,1,1
13,2,2,2,2,2,2,2,2,2,2,2,2,2,2,2,2,2,2,2,2,2,2,2,2,2,2,2,2,2,2,2,2,2,2,1,1,1,1,1,1
14,2,2,2,2,2,2,2,2,2,2,2,2,2,2,2,2,2,2,2,2,2,2,2,2,2,2,2,2,2,2,2,2,2,2,1,1,1,1,1,1
15,2,2,2,2,2,2,2,2,2,2,2,2,2,2,2,2,2,2,2,2,2,2,2,2,2,2,2,2,2,2,2,2,2,2,1,1,1,1,1,1
16,2,2,2,2,2,2,2,2,2,2,2,2,2,2,2,2,2,2,2,2,2,2,2,2,2,2,2,2,2,2,2,2,2,2,1,1,1,1,1,1
17,2,2,2,2,2,2,2,2,2,2,2,2,2,2,2,2,2,2,2,2,2,2,2,2,2,2,2,2,2,2,2,2,2,2,2,1,1,1,1,1
18,2,2,2,2,2,2,2,2,2,2,2,2,1,1,2,2,2,2,2,2,2,2,2,2,2,2,2,2,2,2,2,2,2,2,2,1,1,1,0,0
19,2,2,2,2,2,2,2,2,2,2,2,2,1,1,1,1,1,1,2,2,2,0,0,2,2,2,2,2,2,2,2,2,2,2,1,1,1,0,0,0
20,2,2,2,2,2,2,2,2,2,2,2,2,1,1,1,1,1,1,1,2,0,0,0,2,2,2,2,2,2,2,2,2,2,2,1,1,1,0,0,0
21,2,2,2,2,2,2,2,2,2,2,2,2,0,0,1,1,1,1,1,1,0,0,0,0,2,2,2,2,2,2,2,2,2,2,1,1,1,0,0,0
22,2,2,2,2,2,2,0,0,0,0,0,0,0,0,1,1,1,1,1,1,0,0,0,2,2,2,2,2,2,2,2,2,2,2,1,1,1,0,0,0
23,2,2,2,2,2,2,2,0,0,0,0,0,0,1,1,1,1,1,1,1,1,2,2,2,2,2,2,2,2,2,2,2,2,1,1,1,1,1,1,1
24,2,2,2,2,2,2,0,0,0,0,0,0,0,0,1,1,1,1,1,1,1,2,2,2,2,2,2,2,2,2,1,1,2,2,2,2,2,2,2,1
25,2,2,2,0,0,0,0,0,0,0,0,0,0,0,0,1,1,1,1,1,1,1,1,1,1,1,1,0,0,1,1,2,2,2,2,2,2,2,2,2
26,2,2,2,2,0,0,0,0,0,0,0,0,0,0,2,2,2,2,2,1,1,1,1,1,1,1,0,0,0,1,1,2,2,2,2,2,2,2,2,2
27,2,2,2,2,0,0,0,0,0,0,0,0,0,2,2,2,2,2,2,1,1,1,1,1,1,1,1,0,0,1,1,2,2,2,2,2,2,2,2,2
28,2,2,2,2,2,0,0,0,0,0,0,0,2,2,2,2,2,2,2,1,1,1,1,1,1,1,1,1,1,1,1,2,2,2,2,2,2,2,2,2
29,2,2,2,2,2,2,0,0,1,1,0,2,2,2,2,2,2,2,2,1,1,0,1,1,1,1,1,1,1,1,1,2,2,2,2,2,2,2,2,2
30,1,1,1,1,1,1,1,1,1,1,1,2,2,2,2,2,2,2,2,1,0,0,0,1,1,1,1,1,1,1,1,2,2,2,2,2,2,2,2,2
31,1,1,1,1,1,1,1,1,1,1,1,2,2,2,2,2,2,2,2,1,1,0,0,1,1,1,1,1,1,1,1,2,2,2,2,2,2,2,2,2
32,1,1,1,1,1,1,1,1,1,1,1,2,2,2,2,2,2,2,2,2,1,1,1,1,1,1,1,1,2,2,2,1,2,2,2,2,2,2,2,2
33,1,1,1,1,1,1,1,1,1,1,1,2,2,2,2,2,2,2,2,2,1,1,1,1,1,1,1,1,2,2,2,1,1,1,1,1,1,1,1,1
34,1,1,1,1,1,1,1,1,1,1,1,2,2,2,2,2,2,2,0,0,0,1,1,1,1,1,1,1,2,2,2,1,1,1,1,1,1,1,1,1
35,1,1,1,1,1,1,1,1,1,1,1,2,1,2,2,2,2,2,0,0,0,1,1,1,1,1,1,1,1,1,1,1,1,1,1,1,1,1,1,1
36,1,1,1,1,1,1,1,1,1,1,1,1,1,1,2,2,2,2,2,2,1,1,1,1,1,1,1,1,1,1,1,1,1,1,1,1,1,1,1,1
37,1,1,1,1,1,1,1,1,1,1,1,1,1,1,2,2,2,2,2,2,1,1,1,1,1,0,0,0,1,1,1,1,1,1,1,1,1,1,1,1
38,1,1,1,1,1,1,1,1,1,1,1,1,1,1,1,1,1,1,1,1,1,1,1,1,1,0,0,0,0,1,1,1,1,1,1,1,1,1,1,1
39,1,1,1,1,1,1,1,1,1,1,1,1,1,1,1,1,1,1,1,1,1,1,1,1,1,0,0,0,0,1,1,1,1,1,1,1,1,1,1,1
