,0,1,2,3,4,5,6,7,8,9,10,11,12,13,14,15,16,17,18,19,20,21,22,23,24,25,26,27,28,29,30,31,32,33,34,35,36,37,38,39
0,1,0,0,0,1,1,1,0,0,0,0,0,0,0,0,1,1,1,1,1,1,2,2,2,2,2,0,0,0,0,0,0,0,0,0,0,0,0,0,0
1,1,0,0,0,1,1,1,0,0,0,0,0,0,1,1,1,1,1,1,1,2,2,2,2,2,0,0,0,0,0,0,0,0,0,0,0,0,0,0,0
2,1,1,0,0,1,1,1,1,0,0,0,0,1,1,1,1,1,1,1,2,2,2,2,2,2,0,0,0,0,0,0,1,1,0,0,0,0,0,1,1
3,1,1,0,0,1,1,1,1,0,0,0,1,1,1,1,1,1,1,1,2,2,2,2,2,0,0,0,0,0,0,1,1,1,0,0,0,0,0,1,1
4,0,0,0,0,0,1,1,0,0,0,0,1,1,1,1,1,1,1,1,2,2,2,2,2,0,0,0,0,0,1,1,1,1,1,0,0,0,0,1,2
5,0,0,0,0,0,0,0,0,0,0,0,1,1,1,1,1,1,1,1,2,2,2,2,2,2,0,0,0,1,1,1,1,1,1,2,0,0,0,0,0
6,0,0,0,0,0,0,0,0,0,0,1,1,1,1,1,1,1,1,1,2,2,2,2,2,0,0,0,0,0,1,2,1,1,2,2,0,0,0,0,1
7,1,1,0,0,0,0,0,0,0,0,0,1,1,1,1,1,1,1,1,2,2,2,2,0,0,0,0,0,0,2,1,1,1,1,1,0,0,0,1,1
8,1,1,1,1,1,0,0,0,0,0,0,0,1,1,1,1,1,1,1,2,2,2,2,2,0,2,0,0,2,2,2,2,1,2,1,2,1,1,1,1
9,2,2,2,2,0,0,0,0,0,0,0,0,1,1,1,1,1,1,1,1,2,2,2,2,2,2,2,2,2,2,2,2,2,2,2,2,2,2,1,1
10,2,2,2,2,2,0,0,0,0,0,0,0,2,2,1,1,1,1,1,1,2,2,2,2,2,2,2,2,2,2,2,2,2,2,2,2,2,2,1,1
11,2,2,2,2,2,0,0,2,2,2,0,2,2,2,2,1,1,1,1,1,2,2,2,2,2,2,2,2,2,2,2,2,2,2,2,2,2,2,1,1
12,0,0,0,2,2,0,2,2,2,2,2,2,2,2,2,1,1,1,1,1,2,2,2,2,2,2,2,2,2,2,2,2,2,2,2,2,2,2,1,1
13,0,0,0,0,2,2,2,2,2,2,2,2,2,2,2,2,1,1,1,1,2,2,2,2,2,2,2,2,2,2,2,2,2,2,2,2,2,2,2,1
14,0,0,0,0,2,2,2,2,2,2,2,2,2,2,2,2,0,0,0,1,2,2,2,2,2,2,2,2,2,2,2,2,2,2,2,2,2,2,1,1
15,0,0,2,2,2,2,2,2,2,2,2,2,2,2,2,2,0,0,0,1,1,1,1,1,1,1,2,2,2,2,2,2,2,2,2,2,2,2,2,2
16,0,0,2,2,2,2,2,2,2,2,2,2,2,2,2,0,1,1,1,1,1,1,1,1,1,1,1,2,2,2,2,2,2,2,2,2,2,2,2,2
17,0,2,2,2,2,2,2,2,2,2,2,2,2,2,0,0,1,1,1,1,1,1,1,1,1,1,1,2,2,2,2,2,2,2,2,2,2,2,2,2
18,0,0,2,2,2,2,2,2,2,2,2,2,2,2,0,0,0,2,2,2,1,1,1,1,2,1,1,2,2,2,2,2,2,2,2,2,2,2,2,2
19,0,0,2,2,2,2,2,2,2,2,2,2,2,2,2,0,0,2,2,2,1,1,1,1,1,1,1,1,2,2,2,2,2,2,2,2,2,2,2,2
20,0,2,2,2,2,2,2,2,2,2,2,2,2,2,2,0,0,2,2,2,2,1,1,1,1,1,1,1,1,2,2,2,2,2,2,2,2,2,2,2
21,0,0,2,2,2,2,2,2,2,2,2,2,2,2,2,2,2,2,2,2,2,1,1,1,1,1,1,1,1,1,1,2,2,2,2,2,2,2,2,2
22,0,0,2,2,2,2,2,2,2,2,2,2,2,2,2,2,2,2,2,2,2,2,0,1,1,1,1,1,1,1,1,2,2,2,2,2,2,2,2,2
23,0,0,2,2,2,2,2,2,2,2,2,2,2,2,2,2,2,2,2,2,2,2,0,0,1,1,1,1,1,1,1,1,2,2,2,2,2,2,2,2
24,0,2,2,2,2,2,2,2,2,2,2,2,2,2,2,2,2,2,2,2,2,2,0,1,1,1,1,1,1,1,1,2,2,2,2,2,2,2,2,2
25,1,1,2,2,2,2,2,2,2,2,2,2,2,2,2,2,2,2,2,2,2,2,1,1,1,1,1,1,1,1,1,2,1,0,0,2,2,2,2,2
26,1,1,2,2,2,2,2,2,2,2,2,2,2,2,2,2,0,2,2,2,2,2,1,1,1,1,1,1,1,1,2,1,0,0,0,0,2,2,2,2
27,1,1,2,2,2,2,2,2,2,2,2,2,2,2,2,2,0,0,0,0,2,2,1,1,1,1,1,1,1,1,1,1,0,0,0,0,0,0,0,1
28,1,1,2,2,0,2,2,0,0,2,2,2,2,2,2,2,0,0,0,0,0,1,1,1,1,1,1,1,1,1,1,0,0,0,0,0,0,0,0,0
29,2,2,2,0,0,0,0,0,0,2,2,2,2,2,2,2,0,0,0,0,0,0,2,2,2,2,1,1,1,1,0,0,0,0,0,0,0,0,0,0
30,2,2,2,0,0,0,0,0,0,2,2,2,2,2,2,2,2,2,0,0,0,2,2,2,2,2,2,2,2,2,0,0,0,0,2,2,0,0,0,0
31,2,2,2,0,0,2,2,2,2,2,2,2,2,2,2,2,2,2,0,0,0,2,2,2,2,2,2,2,2,2,0,0,0,0,2,2,2,2,0,0
32,2,2,2,2,2,2,2,2,2,2,2,2,2,2,2,2,2,2,0,0,2,2,2,2,2,2,2,2,2,2,0,0,0,0,2,2,2,2,0,0
33,0,0,0,2,2,2,2,2,2,2,0,0,2,2,2,2,2,2,2,2,2,2,2,2,2,2,2,2,2,2,2,0,2,2,2,2,2,2,0,0
34,0,0,0,2,2,2,2,2,2,0,0,0,2,2,0,0,2,2,2,2,2,2,2,2,2,2,2,2,2,2,2,2,2,2,2,2,2,2,0,0
35,0,0,0,0,2,2,2,2,2,0,0,0,2,0,0,0,0,2,2,2,2,2,2,2,2,2,2,2,2,2,2,2,2,2,2,2,2,2,2,2
36,0,0,0,0,2,2,2,2,2,0,0,0,0,0,0,0,0,2,2,2,2,2,2,2,2,2,2,2,2,2,2,2,2,2,2,2,2,2,2,2
37,0,0,0,0,0,2,2,2,2,2,0,0,0,0,0,0,0,2,2,2,2,2,2,2,2,2,2,2,2,2,2,2,2,2,2,2,2,2,2,2
38,0,0,0,0,0,0,2,2,2,0,0,0,0,0,0,0,0,2,2,2,2,2,2,2,2,2,2,2,2,2,2,2,2,2,2,2,2,2,2,2
39,0,0,0,0,0,0,2,2,2,2,0,0,0,0,0,0,0,2,2,2,2,2,2,2,2,2,2,2,2,2,2,2,2,2,2,2,2,2,2,2
