,0,1,2,3,4,5,6,7,8,9,10,11,12,13,14,15,16,17,18,19,20,21,22,23,24,25,26,27,28,29,30,31,32,33,34,35,36,37,38,39
0,1,1,1,1,1,1,1,1,1,0,0,0,1,1,1,0,0,0,0,1,1,1,0,0,0,0,0,1,1,1,1,1,1,1,1,1,1,1,1,1
1,1,1,1,1,1,1,1,1,1,0,0,0,1,1,1,0,0,0,0,0,1,1,0,0,0,0,1,1,1,1,1,1,1,1,1,1,1,1,1,1
2,1,1,1,1,1,1,0,0,0,0,0,0,1,1,1,1,1,0,0,0,0,0,0,0,0,0,1,1,1,1,1,1,1,1,1,1,1,1,1,1
3,1,1,1,1,1,1,0,0,0,0,0,0,0,1,1,1,1,1,0,0,0,0,0,0,0,0,0,1,1,1,1,1,1,1,1,1,1,1,1,1
4,1,1,1,1,1,1,0,0,0,0,0,0,0,1,1,1,1,1,0,0,0,0,0,0,0,0,0,0,1,1,1,1,1,1,1,1,1,1,1,1
5,1,1,1,1,1,1,0,0,0,0,0,0,1,1,1,1,1,1,0,0,0,0,0,0,0,0,0,0,0,0,0,1,1,1,1,1,0,1,1,1
6,1,1,1,0,1,1,0,0,0,0,0,0,0,1,1,1,1,1,0,0,0,0,0,0,0,0,0,0,0,0,0,1,1,1,1,1,0,0,0,0
7,1,1,0,0,0,0,0,0,0,0,0,0,0,1,1,1,1,1,0,0,0,0,0,0,0,0,0,0,0,0,0,1,1,1,1,1,0,0,0,0
8,1,1,0,0,0,0,0,0,0,0,0,0,0,0,0,0,0,1,1,0,0,0,0,0,0,0,0,0,0,0,0,0,1,1,1,1,0,0,1,1
9,1,1,0,0,0,0,0,0,0,0,0,0,0,0,0,0,0,1,1,0,0,0,0,0,0,0,0,0,0,0,0,1,1,1,1,1,0,1,1,1
10,1,2,0,0,0,0,0,0,0,0,0,0,1,1,0,0,0,2,0,0,0,0,0,0,0,0,0,0,0,1,1,1,1,1,1,1,1,1,1,1
11,2,2,0,0,0,0,0,0,0,0,0,0,1,1,1,2,2,2,2,0,0,0,0,0,0,0,1,1,1,1,1,1,1,1,1,1,1,1,1,1
12,2,0,0,0,0,0,0,0,0,0,0,1,1,1,2,2,2,2,2,2,2,0,0,0,0,1,1,1,1,1,1,1,1,1,1,1,1,1,1,1
13,2,0,0,0,0,0,0,0,2,2,1,1,1,1,2,2,2,2,2,2,2,0,0,0,0,0,1,1,1,2,2,2,2,1,1,1,1,1,1,1
14,0,0,0,0,0,0,0,0,2,2,1,1,1,1,2,2,2,2,2,2,2,0,0,0,0,0,1,1,1,2,2,2,2,2,2,1,1,1,1,1
15,1,0,0,0,0,0,0,0,2,2,1,1,1,1,0,0,2,2,2,2,0,0,0,0,0,1,1,1,1,2,2,2,2,2,0,1,1,1,1,1
16,1,1,0,0,0,1,1,1,0,1,1,1,1,1,0,0,0,2,2,2,0,0,0,0,1,1,1,1,1,2,2,2,2,2,0,0,1,1,1,1
17,1,1,1,1,1,1,1,1,0,0,1,1,1,0,0,0,0,1,1,1,1,0,0,0,1,1,1,1,1,0,0,0,2,0,0,0,1,1,1,1
18,1,1,1,1,1,1,1,0,0,0,0,1,1,0,0,0,0,0,1,1,1,1,0,1,1,1,1,1,1,0,0,0,0,0,0,0,0,1,1,1
19,1,0,0,1,1,0,0,0,0,0,0,0,0,1,2,0,0,2,2,2,2,2,2,2,1,1,1,1,1,0,0,0,0,0,0,0,2,1,1,1
20,0,0,0,0,0,0,0,0,0,0,0,0,0,1,2,2,2,2,2,2,2,2,2,2,2,1,1,1,1,1,0,0,0,0,0,2,2,2,1,1
21,0,0,0,0,0,0,0,0,0,0,0,0,1,1,2,2,2,2,2,2,2,2,2,2,2,1,1,1,1,1,1,0,0,0,0,0,2,2,2,2
22,0,0,0,0,0,0,0,0,0,0,0,1,1,1,2,2,2,2,2,2,2,2,2,2,2,2,2,1,1,1,1,0,0,0,0,0,0,2,2,2
23,0,0,0,0,0,0,0,0,0,0,1,1,1,1,2,2,2,2,2,2,2,2,2,2,2,2,0,0,0,1,1,1,1,1,0,0,0,2,2,2
24,0,0,0,0,0,1,0,0,0,1,2,2,2,1,2,2,0,0,0,0,0,2,2,2,2,2,2,0,0,0,1,1,1,1,0,0,0,0,0,0
25,1,1,1,1,1,1,1,1,2,2,2,2,2,2,2,0,0,0,0,0,0,0,2,2,2,2,2,0,0,0,0,1,1,1,0,0,0,0,0,0
26,1,1,1,1,1,1,1,1,2,2,2,2,2,2,2,2,0,0,0,0,0,0,0,2,2,2,2,0,0,0,0,1,0,0,0,0,0,0,0,0
27,1,1,1,1,1,1,1,1,0,0,2,2,2,2,2,2,0,0,0,0,0,0,2,2,2,2,0,0,0,0,0,0,0,0,0,0,0,0,0,0
28,0,1,1,1,1,1,1,0,0,0,2,2,2,2,2,2,2,2,0,0,0,0,0,2,2,2,0,0,0,0,0,0,0,0,1,1,0,0,0,0
29,0,0,1,0,0,0,0,0,0,0,2,2,2,2,2,2,2,2,0,0,0,0,0,2,2,2,0,0,0,0,0,0,1,1,1,1,1,0,0,0
30,0,0,0,0,0,0,0,0,0,0,2,2,2,2,2,2,2,2,0,0,0,0,0,2,2,2,2,0,1,1,1,0,1,1,1,1,1,0,0,0
31,0,0,0,0,0,0,0,0,0,2,2,2,2,2,2,2,2,2,0,0,0,0,0,1,1,1,1,1,1,1,1,0,0,1,1,1,1,1,0,0
32,2,2,2,0,2,2,0,2,2,2,2,2,2,2,2,2,2,2,1,0,0,0,0,1,1,1,1,1,1,1,0,0,0,1,1,1,1,1,1,1
33,2,2,2,2,2,2,2,2,2,2,2,2,2,2,2,2,2,2,1,0,0,0,0,1,1,1,1,1,2,1,0,0,0,0,2,2,2,1,1,1
34,2,2,2,2,2,2,2,2,2,2,2,2,2,2,2,2,2,2,1,1,1,1,1,1,1,1,1,1,2,2,0,0,0,2,2,2,2,1,1,1
35,2,2,2,2,2,2,2,2,0,2,2,2,2,2,2,2,2,2,1,1,1,1,1,1,1,1,1,1,2,2,2,0,2,2,2,2,2,2,1,0
36,2,2,2,2,2,2,2,0,0,0,2,2,2,2,2,2,2,2,1,1,1,1,1,1,1,1,1,1,2,2,2,2,2,2,2,2,2,1,0,0
37,2,2,2,2,2,2,2,0,0,0,2,2,2,2,2,2,0,0,0,0,1,1,1,1,1,1,1,1,2,2,2,2,2,2,2,2,2,1,0,0
38,2,2,2,2,2,2,2,0,0,0,2,2,2,2,2,2,0,0,0,0,1,1,1,1,1,0,0,0,2,2,2,2,2,2,2,2,2,1,0,0
39,2,2,2,2,2,2,2,2,2,2,2,2,2,2,2,2,0,0,0,0,0,0,1,1,1,0,0,0,2,2,2,2,2,2,2,2,2,0,0,0
