,0,1,2,3,4,5,6,7,8,9,10,11,12,13,14,15,16,17,18,19,20,21,22,23,24,25,26,27,28,29,30,31,32,33,34,35,36,37,38,39
0,1,1,0,0,1,1,1,1,0,0,0,1,0,0,0,2,2,2,2,2,2,2,2,2,0,0,0,0,0,1,1,0,0,0,0,0,0,1,1,1
1,1,0,0,0,1,1,1,1,0,0,0,2,2,0,0,2,2,2,2,2,2,2,2,2,2,0,0,0,0,1,1,1,0,0,0,0,1,1,1,1
2,0,0,0,0,1,1,1,1,0,0,0,2,2,0,2,2,2,2,2,2,2,2,2,2,2,2,0,0,0,0,1,1,1,1,1,1,1,1,1,1
3,0,0,0,0,1,1,1,1,0,0,0,0,2,2,2,2,2,2,2,2,2,2,2,2,2,2,0,0,0,0,0,1,1,1,1,1,1,1,1,1
4,0,0,0,0,0,1,1,1,1,0,1,1,2,2,2,2,2,2,2,2,2,2,2,0,0,0,0,0,0,0,0,0,1,1,1,1,1,1,0,0
5,1,1,0,0,0,1,1,1,1,1,1,1,2,2,2,2,2,2,2,2,1,1,1,1,0,0,0,0,0,0,0,0,1,1,1,1,0,0,0,0
6,1,0,0,0,0,1,1,1,1,1,1,1,1,0,0,0,0,0,0,1,1,1,1,0,0,0,0,0,0,0,0,0,1,1,1,1,0,0,0,0
7,0,0,0,0,1,1,1,1,1,1,1,1,1,0,0,0,0,0,0,1,1,1,0,0,0,0,0,0,0,1,1,1,1,1,1,1,0,0,0,0
8,1,0,0,1,1,1,1,1,1,1,1,1,0,0,0,0,1,0,1,1,1,0,0,0,0,0,0,2,2,1,1,1,1,1,1,1,0,0,0,0
9,1,1,1,1,1,1,1,1,1,1,1,1,0,0,0,2,2,2,1,1,1,1,0,0,0,0,0,1,2,1,1,1,1,1,1,0,0,0,0,0
10,1,1,1,1,1,1,1,1,1,1,1,1,2,0,0,2,2,2,2,1,1,1,1,0,0,0,0,0,1,1,1,1,1,1,1,0,0,0,0,0
11,1,1,1,1,1,1,1,0,0,0,1,1,2,2,2,2,2,2,2,2,1,1,0,0,0,0,0,0,1,1,1,1,1,1,1,1,0,0,0,0
12,1,1,1,1,0,0,0,0,0,0,2,2,2,2,2,2,2,2,0,0,0,0,0,0,0,0,0,0,0,1,1,1,1,1,1,1,1,0,1,1
13,1,1,1,1,0,0,0,0,2,2,2,2,2,2,2,2,2,2,0,0,0,0,0,0,0,0,0,0,1,1,1,1,1,1,1,1,1,2,1,1
14,1,1,1,0,0,0,0,2,2,2,2,2,2,2,2,2,2,0,0,0,0,0,0,0,0,0,0,1,1,1,1,1,1,1,1,1,2,2,1,1
15,0,0,0,0,0,0,0,2,2,2,2,2,2,2,0,0,0,0,0,0,0,0,0,0,0,1,1,1,1,1,1,1,1,1,1,1,1,1,1,1
16,0,0,0,0,1,0,0,2,2,2,2,2,2,0,0,0,0,0,0,0,0,0,0,1,1,1,1,1,1,1,1,1,1,1,1,1,1,1,1,1
17,0,0,0,1,1,1,2,2,2,2,2,2,2,0,0,0,0,0,0,0,0,0,1,1,1,1,1,1,1,1,1,1,1,1,1,1,1,1,1,1
18,0,0,1,1,1,1,1,1,2,2,1,2,1,0,1,2,0,0,0,0,0,0,1,1,0,1,1,1,1,1,1,1,1,1,1,1,1,1,1,1
19,0,0,1,1,1,1,1,1,2,1,2,2,1,1,2,2,2,0,0,0,1,1,1,0,0,0,1,1,2,2,2,2,2,1,1,1,1,1,1,1
20,0,0,1,1,1,1,1,2,2,2,2,2,2,1,2,2,2,2,1,1,1,1,1,1,0,0,1,2,2,2,2,2,0,1,0,0,1,1,1,1
21,0,0,1,1,1,1,2,2,2,2,2,2,2,1,1,1,1,1,1,1,1,1,1,1,0,0,0,2,2,2,2,0,0,0,0,0,0,1,1,1
22,1,1,1,1,1,1,2,2,2,2,2,2,2,2,1,1,1,1,1,1,1,0,0,0,0,0,0,2,2,2,2,0,0,0,0,0,0,0,1,1
23,1,1,1,1,1,1,2,2,2,2,2,2,2,2,1,1,1,1,1,1,1,1,0,0,0,0,0,2,2,2,2,2,0,2,1,0,0,0,0,1
24,1,1,1,1,1,1,2,2,2,2,2,2,2,2,1,1,1,1,0,0,1,1,1,0,0,0,0,2,2,2,2,2,2,1,1,1,0,0,0,1
25,1,1,1,1,1,1,2,2,2,2,2,2,2,2,1,2,2,0,0,0,1,1,1,0,0,0,0,0,2,2,2,2,2,1,1,1,0,0,1,1
26,1,1,1,1,1,1,1,2,2,2,2,2,2,1,2,2,2,0,0,0,1,1,0,0,0,0,0,0,0,2,2,1,1,1,1,1,1,1,1,1
27,1,1,1,1,1,1,1,1,1,2,2,1,1,1,1,2,2,0,0,0,0,0,0,0,0,0,0,1,1,1,1,1,1,1,1,2,1,2,0,0
28,1,1,1,1,1,1,1,1,1,1,1,1,1,1,1,0,0,0,0,0,0,0,0,0,0,0,1,1,1,1,1,1,1,1,0,0,2,0,0,0
29,1,1,1,1,1,1,1,1,1,1,1,1,0,0,0,0,0,0,0,0,0,0,0,0,0,1,1,1,1,1,1,1,1,0,0,0,0,0,0,0
30,1,1,1,1,1,1,1,1,1,1,1,1,0,0,0,0,0,0,0,0,0,0,0,0,1,1,1,1,1,1,1,0,0,0,0,0,0,0,0,0
31,1,1,1,1,1,1,1,1,1,1,1,1,0,0,0,0,0,0,0,0,0,0,0,0,1,1,1,1,1,0,0,0,0,0,0,0,0,0,0,0
32,1,1,1,1,1,1,1,1,0,1,1,1,0,0,0,0,0,0,0,0,0,0,0,0,0,1,1,1,1,1,0,0,0,0,0,0,0,0,0,0
33,1,1,1,1,1,1,1,1,0,0,1,1,1,1,0,0,0,0,0,0,0,0,0,0,0,1,1,1,1,1,0,0,0,0,0,0,0,0,0,0
34,1,1,1,1,1,1,1,1,0,0,1,1,1,0,0,0,0,0,0,0,0,0,0,0,0,1,1,1,1,1,0,0,0,0,0,0,0,0,0,0
35,1,1,1,1,1,1,1,1,1,1,1,1,0,0,0,0,0,0,0,0,0,0,0,0,0,0,0,0,0,0,0,0,0,1,1,1,0,0,0,0
36,1,1,1,1,1,1,1,2,2,1,2,1,0,0,0,0,0,0,0,0,0,0,0,0,0,0,0,0,0,0,0,0,0,0,1,1,0,0,0,0
37,1,2,2,2,1,2,2,2,2,2,2,2,0,0,0,0,0,0,0,0,0,0,0,0,0,0,0,0,0,0,0,1,0,0,1,1,1,1,1,0
38,2,2,2,2,2,2,2,2,2,2,2,0,0,0,0,0,0,0,0,0,0,0,0,0,0,0,0,0,0,0,1,1,1,1,1,1,1,1,1,1
39,1,2,1,2,1,2,2,2,2,2,2,0,0,0,0,0,0,0,0,0,0,0,0,0,0,0,0,0,0,1,1,1,1,1,1,1,1,1,1,1
