,0,1,2,3,4,5,6,7,8,9,10,11,12,13,14,15,16,17,18,19,20,21,22,23,24,25,26,27,28,29,30,31,32,33,34,35,36,37,38,39
0,1,1,1,1,1,1,1,1,1,1,1,1,2,2,2,2,2,2,0,0,0,0,0,0,0,0,0,0,0,1,1,1,1,1,1,1,1,1,1,1
1,1,1,1,1,1,1,1,1,1,1,1,2,2,2,2,2,2,2,1,0,0,0,0,0,0,0,0,0,0,1,1,1,1,1,1,1,1,1,1,1
2,0,0,1,1,1,1,1,1,1,1,1,2,2,2,2,2,2,2,1,1,0,0,0,0,0,0,0,0,0,0,1,1,1,1,1,1,1,1,1,1
3,0,0,0,1,1,1,1,1,1,1,0,0,0,2,2,2,2,2,1,1,0,0,0,0,0,0,0,0,0,1,1,1,1,1,1,1,1,1,1,1
4,0,0,0,1,1,1,1,1,1,1,1,0,0,0,2,2,2,2,1,1,0,0,0,0,0,0,0,1,1,1,1,1,1,1,1,0,1,1,1,1
5,0,0,0,1,1,1,1,1,1,1,1,1,1,2,2,2,2,1,1,1,1,0,0,0,0,0,0,1,1,1,1,1,1,1,0,0,0,0,0,1
6,0,0,0,0,0,0,1,1,1,1,1,1,1,1,1,1,1,1,1,1,1,0,0,0,0,0,0,0,1,1,1,1,1,0,0,0,0,0,0,0
7,0,0,0,0,0,0,1,1,1,2,1,1,1,1,1,1,1,1,1,1,1,0,0,0,0,0,0,0,0,0,1,1,1,0,0,0,0,0,0,0
8,0,0,0,0,0,1,1,1,2,1,0,1,1,1,1,1,1,1,1,1,1,1,0,0,0,0,0,0,0,0,0,1,1,0,0,0,0,0,0,0
9,0,0,0,0,1,1,1,2,2,0,0,0,1,0,1,1,1,0,0,1,1,1,0,1,1,0,0,0,0,0,0,0,0,0,0,0,0,0,0,0
10,1,1,1,1,1,1,1,1,0,0,0,0,0,0,0,1,1,0,0,0,0,1,1,1,1,2,2,0,0,0,0,0,0,0,0,0,0,0,0,0
11,1,1,1,1,1,1,1,0,0,0,0,0,0,0,0,0,1,1,0,0,1,1,1,1,1,1,2,0,0,0,0,0,0,0,0,0,0,0,0,0
12,0,1,0,0,1,1,1,0,0,0,0,2,2,0,0,0,1,1,0,1,1,1,1,1,1,1,2,0,0,0,0,0,0,0,0,0,0,0,0,0
13,0,0,0,0,1,1,1,0,0,2,2,2,2,2,0,0,0,1,1,1,1,1,1,0,0,1,0,0,0,0,0,0,0,0,0,0,0,0,0,0
14,0,0,0,0,0,0,0,0,0,2,2,2,2,2,0,0,0,1,1,1,1,1,0,0,0,0,0,0,0,0,0,0,0,0,0,0,0,0,0,0
15,0,0,2,2,2,0,0,0,2,2,2,2,2,2,0,0,1,1,1,1,1,0,0,0,0,0,0,0,0,0,0,0,0,0,0,0,0,0,0,0
16,0,2,2,2,2,2,2,2,2,2,2,2,2,0,0,0,1,1,1,1,1,1,0,0,0,0,0,0,0,0,0,0,0,0,0,0,0,0,0,0
17,2,2,2,2,2,2,2,2,2,2,2,0,0,0,0,0,1,1,1,1,1,1,1,0,0,0,0,0,0,0,0,0,0,0,0,1,1,0,0,0
18,2,2,2,2,2,2,2,2,2,2,2,0,0,0,0,0,1,1,1,1,1,1,0,0,0,0,0,0,0,0,0,0,0,0,0,1,1,1,1,0
19,2,2,2,2,2,2,2,2,2,2,2,0,0,0,0,1,2,1,1,1,1,2,1,1,0,0,0,0,1,1,1,0,0,0,1,1,1,1,1,1
20,2,2,2,2,2,2,2,1,1,1,2,0,0,0,0,0,1,1,1,2,2,2,2,2,2,0,0,0,1,1,1,0,0,0,1,2,1,1,1,1
21,2,2,2,2,2,2,2,1,1,1,1,0,0,0,0,0,1,1,0,0,2,2,2,2,2,0,0,1,1,1,1,0,0,0,1,1,1,1,1,1
22,2,2,2,2,2,2,2,1,0,0,0,0,0,0,0,1,1,1,0,0,0,2,2,2,2,2,2,1,1,1,0,0,0,0,1,1,1,1,1,1
23,2,2,2,2,2,2,2,0,0,0,0,0,0,0,0,1,1,0,0,0,2,2,2,2,2,2,2,1,1,1,0,0,0,0,0,0,0,1,1,1
24,2,2,2,2,2,2,0,0,0,0,0,0,0,0,0,0,0,0,0,2,2,2,2,2,2,0,0,1,1,1,0,0,0,0,0,0,0,1,1,1
25,0,0,2,2,2,1,1,0,0,0,0,0,2,2,2,2,0,0,2,2,2,2,2,2,0,0,0,0,1,1,1,1,1,0,0,0,1,1,1,1
26,0,0,1,1,1,1,1,2,2,2,2,2,2,2,2,2,2,2,2,2,2,2,2,2,0,0,0,0,0,0,0,1,1,0,0,1,1,1,1,1
27,0,0,0,0,0,1,1,1,2,2,2,2,2,2,2,2,2,2,2,2,2,2,2,0,0,0,0,0,0,0,0,0,0,0,1,1,1,1,1,1
28,0,0,0,0,0,0,1,1,2,2,2,2,2,2,2,2,2,2,2,2,2,2,2,0,0,0,0,0,0,0,0,0,0,0,1,1,1,1,1,1
29,0,0,0,0,0,0,1,1,2,2,2,2,2,0,0,0,2,2,2,2,2,2,2,2,0,0,0,0,0,0,0,0,0,0,0,2,2,2,2,2
30,0,0,0,0,0,0,1,1,2,2,2,2,2,0,0,2,2,2,2,2,2,2,2,2,2,2,0,0,0,0,0,0,0,0,0,2,2,2,2,2
31,0,0,0,0,0,0,1,1,2,2,2,2,2,2,2,2,2,2,2,2,2,2,2,2,2,2,2,2,0,0,0,0,0,0,0,2,2,2,2,2
32,0,0,2,0,0,0,2,1,1,2,2,2,2,2,2,2,2,2,2,2,2,2,2,2,2,2,2,2,1,2,0,0,0,0,2,2,2,2,2,2
33,0,2,2,2,0,2,2,1,1,2,2,2,2,2,2,2,2,2,2,2,2,2,2,2,2,2,2,2,1,2,2,2,2,2,2,2,2,2,2,0
34,2,2,2,2,2,2,2,1,1,1,1,1,2,2,2,2,2,2,2,2,2,2,2,2,2,2,2,1,1,2,2,2,2,2,2,2,2,2,0,0
35,2,2,2,2,2,2,2,2,1,1,1,1,1,1,2,2,2,2,2,2,2,2,2,2,2,2,2,1,1,2,2,2,2,2,2,2,0,0,0,0
36,2,2,2,2,2,2,2,1,1,1,0,1,1,1,1,1,1,1,2,2,2,2,2,2,2,1,1,1,1,2,2,2,2,2,2,2,0,0,0,0
37,2,2,2,2,0,0,2,2,1,0,0,1,1,1,1,1,1,1,1,1,1,1,1,1,1,1,0,0,1,1,2,2,2,2,2,0,0,0,0,0
38,2,2,2,2,0,0,0,0,0,0,0,0,1,1,1,1,1,1,1,1,1,1,2,1,1,1,0,0,1,1,2,2,0,0,0,0,0,0,0,0
39,2,2,2,2,2,0,0,0,0,0,0,0,1,1,1,1,1,1,1,1,1,1,1,1,1,1,0,0,1,1,2,0,0,0,0,0,0,0,0,0
