,0,1,2,3,4,5,6,7,8,9,10,11,12,13,14,15,16,17,18,19,20,21,22,23,24,25,26,27,28,29,30,31,32,33,34,35,36,37,38,39
0,0,0,0,0,2,2,2,2,2,2,2,1,1,1,1,1,1,1,1,1,1,1,1,1,1,1,1,1,1,1,1,1,2,2,2,2,2,2,2,2
1,0,0,0,0,2,2,2,2,2,2,2,1,1,1,1,1,1,1,1,1,1,1,1,1,1,1,1,2,2,2,2,2,2,2,2,2,2,2,2,2
2,0,0,2,2,2,2,2,2,2,2,2,1,1,1,1,1,1,0,1,1,1,1,1,1,1,2,2,2,2,2,2,2,2,2,2,2,2,2,2,2
3,0,2,2,2,2,2,2,2,2,2,2,1,1,1,1,1,1,0,0,1,1,1,1,1,1,2,2,2,2,2,2,2,2,2,2,2,2,2,2,2
4,2,2,2,2,2,2,2,2,2,2,2,1,1,1,0,1,0,0,0,0,1,1,1,1,1,2,2,2,2,2,2,2,2,2,2,2,2,2,2,1
5,2,2,2,2,2,2,2,2,2,2,2,1,0,0,0,0,0,0,0,0,1,1,1,1,2,2,2,2,2,2,2,2,2,2,2,2,2,2,2,1
6,2,2,2,2,2,2,2,2,2,2,2,1,0,0,0,1,0,0,0,0,1,1,1,1,2,2,2,2,2,2,2,2,2,2,2,2,2,2,2,1
7,0,0,0,0,2,2,2,2,2,2,1,1,0,1,1,1,1,0,0,1,1,1,1,1,2,2,2,2,2,2,2,2,2,2,2,2,2,2,2,1
8,0,0,0,0,2,2,2,2,2,2,1,0,0,1,1,1,1,1,1,1,2,1,1,1,2,2,2,2,2,2,2,2,2,2,2,2,2,2,2,1
9,0,0,0,0,2,2,2,2,2,2,0,0,0,0,1,1,1,1,1,1,1,2,1,1,2,2,2,2,2,2,2,2,2,2,2,2,2,2,2,1
10,2,2,2,2,2,2,2,2,2,0,0,0,0,0,1,1,1,2,2,2,1,2,2,1,2,2,2,2,2,2,2,2,2,2,2,2,2,2,2,1
11,2,2,2,2,2,2,2,2,0,0,0,0,0,0,0,1,1,2,2,2,1,1,2,1,2,2,2,2,2,2,2,2,2,2,2,2,2,2,2,1
12,2,2,2,2,0,0,0,2,2,0,0,0,0,0,1,1,1,2,2,2,1,1,1,1,2,2,2,2,2,2,2,2,2,2,2,2,2,2,2,1
13,2,2,2,2,0,0,0,2,2,2,0,0,0,0,1,1,1,1,1,1,1,1,1,1,1,2,2,2,2,2,2,2,2,2,2,2,2,2,2,1
14,2,2,2,2,2,0,2,2,2,2,0,0,0,0,0,1,0,0,1,1,1,1,1,1,1,1,2,2,2,2,2,2,2,2,2,2,2,2,1,1
15,2,2,2,2,2,2,2,2,2,0,0,0,0,0,0,0,0,0,1,1,1,1,1,1,1,1,1,1,2,2,0,0,0,0,0,2,2,1,2,1
16,2,2,2,2,2,2,2,2,2,2,0,0,0,0,0,0,0,0,1,1,1,1,1,1,1,1,2,2,1,0,0,0,0,0,0,0,1,1,1,1
17,2,2,2,2,2,2,2,2,2,2,0,0,1,1,1,0,0,0,1,1,1,1,1,1,2,2,2,2,2,0,0,0,0,0,0,0,1,1,1,1
18,2,2,2,2,2,2,2,2,2,2,0,0,1,2,1,1,1,1,1,1,1,1,1,1,2,2,2,2,2,0,0,0,0,0,0,0,2,2,2,1
19,2,2,2,2,2,2,2,2,2,2,0,0,2,2,2,1,1,1,1,1,1,1,0,1,0,2,2,2,2,0,0,0,0,0,0,0,2,2,2,2
20,2,2,2,2,2,2,2,2,2,2,2,2,2,2,2,2,1,1,1,1,1,0,0,0,0,0,0,2,2,0,0,0,0,2,2,2,2,2,2,2
21,2,2,2,2,2,2,2,2,2,2,2,2,2,2,2,0,0,0,1,1,1,1,0,0,0,0,2,2,2,2,0,0,0,2,2,2,2,2,2,2
22,2,2,2,2,2,2,2,2,2,2,2,2,2,2,2,2,0,0,0,1,1,1,1,1,0,2,2,2,2,2,2,0,0,2,2,2,2,2,2,2
23,2,2,2,2,2,2,2,2,2,2,2,2,2,2,2,2,1,0,0,0,1,1,1,1,2,2,2,2,2,2,2,2,2,2,2,2,2,2,2,2
24,1,1,1,2,2,2,2,2,2,2,2,2,2,2,2,2,1,1,1,1,1,1,1,1,1,2,2,2,2,2,2,2,2,2,2,2,2,2,2,2
25,1,1,1,1,1,1,1,0,0,0,2,2,2,2,2,2,1,1,1,1,1,1,1,1,1,1,2,0,2,2,2,2,2,2,2,2,2,2,2,2
26,2,1,1,1,1,1,1,0,0,0,1,1,1,1,1,1,1,1,1,1,1,0,0,1,1,1,0,0,0,0,0,2,2,2,2,2,2,2,0,0
27,2,2,2,2,2,2,1,0,0,0,0,1,1,1,1,1,1,1,2,2,1,0,0,0,1,1,0,0,0,0,0,2,2,2,2,2,2,0,0,0
28,2,2,2,2,2,0,0,0,0,0,0,0,0,1,1,1,1,1,1,2,2,0,0,0,1,1,1,0,0,0,2,2,2,2,2,2,2,2,0,0
29,2,2,2,2,0,0,0,0,0,0,0,0,0,1,1,1,1,1,0,0,0,0,1,1,1,1,1,0,0,2,2,2,2,2,2,2,2,2,2,2
30,2,2,2,2,0,0,0,0,0,0,0,0,0,0,1,1,1,1,0,0,0,0,1,1,1,0,0,0,0,2,2,2,2,2,2,2,2,2,2,2
31,2,2,2,0,0,0,0,0,0,0,0,0,0,0,1,1,1,1,0,0,0,1,1,1,0,0,0,0,0,2,2,2,2,2,2,2,2,2,2,1
32,2,2,2,2,0,0,0,0,0,0,0,2,2,1,0,0,1,1,1,1,1,1,1,1,0,0,0,0,0,2,2,2,2,0,0,2,2,2,1,1
33,2,2,2,2,0,0,0,0,0,0,2,2,2,1,0,0,1,1,1,1,1,1,1,1,2,1,0,0,2,2,2,2,0,0,0,1,2,1,1,1
34,2,2,2,2,0,0,0,0,0,0,1,2,2,1,0,0,1,1,1,1,1,1,1,1,2,2,2,2,0,0,2,2,2,0,1,1,1,1,1,1
35,2,2,2,2,0,0,0,0,0,0,2,2,2,1,0,1,1,1,1,1,1,1,1,1,1,2,2,0,0,0,0,2,2,2,1,1,1,1,1,1
36,2,2,2,0,0,0,0,0,0,1,2,2,2,1,1,1,1,1,1,1,1,1,1,1,1,0,0,0,0,0,0,0,2,2,1,1,1,1,1,1
37,2,2,0,0,0,0,0,0,0,0,1,1,1,1,1,2,2,2,1,1,1,1,1,0,0,0,0,0,0,0,0,0,0,1,1,1,1,1,1,1
38,2,0,0,0,0,0,0,0,0,0,0,1,1,1,1,2,2,2,2,1,1,1,1,0,0,0,0,0,0,0,0,0,0,1,1,1,1,1,1,1
39,2,2,0,0,0,0,0,0,0,0,0,1,1,1,1,2,2,2,1,1,1,1,0,0,0,0,0,0,0,0,0,0,0,0,1,1,1,1,1,1
