,0,1,2,3,4,5,6,7,8,9,10,11,12,13,14,15,16,17,18,19,20,21,22,23,24,25,26,27,28,29,30,31,32,33,34,35,36,37,38,39
0,1,1,1,1,1,1,1,1,1,0,0,1,1,1,1,0,0,0,0,1,1,1,1,1,1,1,1,0,0,0,1,1,1,1,1,1,1,1,1,1
1,1,1,1,1,1,1,1,1,0,0,0,1,1,1,1,0,0,0,0,1,1,1,1,1,1,1,0,0,0,0,0,1,1,1,1,1,1,1,1,1
2,1,1,1,1,1,1,1,1,0,0,0,1,1,1,1,0,0,0,0,0,1,1,1,1,1,1,0,0,0,0,0,1,1,1,1,1,1,1,1,1
3,1,1,1,1,1,1,1,1,1,0,0,1,1,1,1,0,0,0,0,1,1,1,1,1,1,0,0,0,0,0,0,1,1,1,1,1,1,1,1,1
4,1,1,1,1,1,1,1,1,1,1,1,1,1,1,0,0,0,0,0,1,1,1,1,1,1,1,0,0,0,0,0,1,1,1,1,1,1,1,1,0
5,1,1,1,1,1,1,1,1,1,1,1,1,1,1,0,0,0,0,0,1,1,1,1,1,1,1,1,1,0,0,1,1,1,1,1,1,1,1,0,0
6,1,1,1,1,1,1,1,1,1,1,1,1,1,1,0,0,0,0,1,1,1,1,1,1,1,1,1,1,1,0,1,1,1,1,1,1,1,0,0,0
7,1,1,1,1,1,1,1,1,1,1,1,1,1,1,0,0,0,0,2,1,1,1,1,1,1,1,1,1,1,0,1,1,1,1,1,1,1,0,0,0
8,1,1,1,1,1,1,1,1,1,1,1,1,1,1,2,2,2,2,2,1,1,1,1,1,1,1,1,1,0,0,1,1,1,1,1,1,0,0,0,0
9,1,1,1,1,1,1,1,1,1,1,1,1,1,1,2,2,2,2,2,2,1,1,1,1,1,1,1,0,0,0,0,1,1,1,1,1,0,0,0,0
10,1,1,1,1,1,1,1,1,1,1,1,1,1,1,2,2,2,2,2,2,1,1,1,1,1,1,1,1,0,1,1,1,1,1,1,1,0,0,0,0
11,1,1,1,1,1,1,0,1,1,1,1,1,1,1,2,2,2,2,2,2,2,2,2,2,2,2,2,2,2,1,1,1,1,1,0,0,0,0,0,0
12,1,1,1,1,1,0,0,0,1,1,1,1,1,2,2,2,2,2,2,2,2,2,2,2,2,2,2,2,2,2,2,1,1,1,0,0,0,0,0,0
13,1,1,1,1,0,0,0,0,0,0,1,1,1,2,2,2,2,2,2,0,0,0,2,2,2,2,2,2,2,2,2,1,1,1,1,1,1,0,0,0
14,0,0,0,1,0,0,0,0,0,0,0,1,1,2,2,2,2,2,2,0,0,0,2,2,2,2,2,2,2,2,2,1,1,1,1,1,1,1,1,0
15,0,1,1,1,1,1,1,1,0,0,1,1,1,2,2,2,2,2,2,2,2,0,2,2,2,2,2,2,2,2,2,1,1,1,1,1,1,1,1,1
16,1,1,1,1,1,1,1,1,1,1,1,1,1,2,2,2,2,2,2,2,2,2,2,2,2,2,2,2,2,2,2,1,1,1,1,1,1,1,1,1
17,1,1,1,1,1,1,1,1,0,0,1,1,1,2,2,2,2,2,2,2,2,2,2,2,2,2,2,2,2,2,2,1,1,1,1,1,1,1,1,1
18,1,1,1,1,1,1,1,1,0,0,0,1,1,2,2,2,2,2,2,2,2,2,2,2,2,2,2,2,2,2,2,1,1,1,1,1,1,1,1,1
19,1,1,1,1,1,1,1,1,0,0,0,1,1,2,2,2,2,2,2,2,2,2,2,2,2,2,2,2,2,2,2,1,1,1,1,1,1,1,1,1
20,1,1,1,1,1,1,1,1,0,0,1,1,2,2,2,2,2,2,2,2,2,2,2,0,0,2,2,2,2,2,2,2,1,1,1,1,1,1,1,1
21,1,1,1,1,1,0,0,0,0,0,0,1,2,2,2,2,2,2,0,0,0,2,0,0,0,0,2,2,2,2,2,1,1,1,1,1,1,1,1,1
22,1,1,1,1,1,0,0,0,0,0,1,1,1,2,2,2,2,0,0,0,0,0,2,2,0,2,2,2,2,2,2,1,1,1,1,1,1,1,1,1
23,1,1,1,1,0,0,0,0,0,0,0,1,1,2,0,0,0,0,0,0,0,0,2,2,2,2,2,2,2,2,2,1,1,1,1,1,1,1,1,1
24,1,1,1,1,0,0,0,1,0,0,0,1,1,1,0,0,0,0,0,0,0,0,2,2,2,2,2,2,2,2,2,1,1,1,1,1,1,1,1,1
25,2,2,2,1,1,0,1,1,1,0,1,1,1,1,0,0,0,0,0,0,0,0,2,2,2,2,2,2,2,2,1,1,2,2,2,2,2,2,1,1
26,2,2,2,1,1,1,1,1,1,1,1,1,1,1,0,0,0,0,0,0,0,0,2,2,2,2,2,2,2,1,1,1,2,2,2,2,2,2,2,1
27,2,2,1,1,1,1,1,1,1,1,1,1,1,1,0,0,0,0,0,0,0,0,2,2,2,2,2,2,2,1,1,1,2,2,2,2,2,2,2,1
28,1,1,1,1,1,1,1,1,1,1,1,1,1,0,0,0,0,0,0,1,1,2,2,2,2,2,2,1,1,1,1,1,2,2,2,2,2,0,0,0
29,1,1,1,1,1,0,0,0,1,1,1,1,1,0,0,0,0,0,0,1,1,1,1,1,1,1,1,1,1,1,1,1,1,2,2,2,2,0,0,0
30,0,0,0,0,0,0,0,0,1,1,1,1,0,0,0,0,0,0,0,0,1,1,1,1,1,1,1,0,0,1,1,1,1,1,2,2,0,0,0,0
31,1,0,0,0,0,0,0,1,1,1,1,1,0,0,0,0,0,0,0,0,1,1,1,1,1,1,0,0,0,1,1,1,1,1,1,1,0,0,0,0
32,1,1,0,0,0,1,1,1,1,1,1,1,1,0,0,0,0,0,0,0,1,1,1,1,1,1,0,0,0,1,1,1,1,1,1,1,1,0,0,0
33,1,1,1,1,1,1,1,1,1,1,1,1,1,1,1,0,0,0,0,1,2,2,2,1,1,1,0,0,0,1,1,1,1,1,1,1,1,0,0,0
34,1,1,1,1,1,1,1,1,1,1,1,1,1,1,1,0,0,0,0,1,2,2,2,1,1,1,0,0,0,0,0,1,1,1,1,1,1,1,0,0
35,1,1,1,1,1,1,0,0,0,1,1,1,1,1,0,0,0,0,0,0,2,2,2,1,1,1,1,0,0,0,0,0,1,1,1,1,1,1,0,0
36,1,1,1,1,1,0,0,0,0,1,1,1,1,1,0,0,0,0,0,0,1,1,1,1,1,1,1,0,0,0,0,0,1,1,1,1,1,1,1,0
37,1,1,1,1,1,0,0,0,0,0,1,1,1,1,1,0,0,0,0,0,0,1,1,1,1,1,1,1,1,0,0,0,0,1,1,1,1,1,1,0
38,1,1,1,1,1,1,0,0,0,0,0,0,1,1,1,1,0,0,0,0,0,0,0,0,1,1,1,1,1,0,0,0,0,1,1,1,1,1,1,1
39,1,1,1,1,1,1,1,1,0,0,0,0,1,1,1,1,0,0,0,0,0,0,0,0,0,1,1,1,1,1,0,0,0,1,1,1,1,1,1,1
