,0,1,2,3,4,5,6,7,8,9,10,11,12,13,14,15,16,17,18,19,20,21,22,23,24,25,26,27,28,29,30,31,32,33,34,35,36,37,38,39
0,0,0,0,1,1,0,0,0,1,1,2,2,2,2,2,2,1,2,1,1,1,1,0,0,0,0,0,0,0,1,1,1,0,0,0,0,0,0,0,0
1,0,0,0,1,1,1,0,0,1,2,2,2,2,2,2,2,2,2,2,1,1,1,0,0,0,0,0,0,0,1,1,1,1,0,0,0,0,0,0,0
2,0,0,0,0,1,1,0,0,0,2,2,2,2,2,2,2,2,2,2,1,1,1,0,0,0,0,0,0,0,1,1,1,1,0,0,0,0,0,0,0
3,0,0,0,0,0,0,0,0,0,0,2,2,2,2,2,2,2,2,2,2,1,1,1,1,1,1,0,0,0,1,1,1,1,0,0,0,0,0,1,1
4,0,0,0,0,1,1,0,0,0,0,0,0,2,2,2,2,2,2,2,2,1,1,1,1,1,1,1,0,1,1,1,1,0,0,0,0,0,1,1,1
5,0,0,0,0,1,1,1,1,0,0,0,2,2,2,2,2,2,2,2,0,0,1,1,1,1,1,0,0,1,1,1,0,0,0,0,0,0,1,1,1
6,0,0,0,0,1,1,1,1,1,1,0,0,2,2,2,2,2,2,2,0,0,0,0,0,1,0,0,0,0,1,1,0,0,0,0,0,0,0,1,1
7,1,1,0,0,1,1,1,1,1,0,0,0,0,0,2,2,2,2,0,0,0,0,0,0,0,0,0,0,0,0,0,0,0,1,1,0,0,0,1,1
8,1,1,1,1,1,1,1,1,1,0,0,0,0,0,2,2,2,0,0,0,0,0,0,0,0,0,0,1,1,0,0,0,1,1,1,1,1,1,1,1
9,1,1,1,1,1,1,1,1,1,1,1,0,0,0,2,2,2,2,0,0,0,0,0,0,0,0,2,1,1,0,0,0,1,1,1,1,1,1,1,1
10,1,1,1,1,1,1,1,1,1,1,1,1,1,2,0,0,2,2,2,0,0,0,0,0,0,0,2,2,2,0,0,1,1,1,1,1,1,1,1,1
11,1,1,1,1,1,1,1,1,1,1,1,1,1,0,0,0,1,1,1,0,0,0,0,0,0,0,2,2,2,0,0,1,1,1,1,1,1,1,1,1
12,1,1,1,1,1,1,1,1,1,1,1,1,0,0,0,0,1,1,0,0,0,0,0,0,0,0,0,2,2,2,1,1,1,1,1,1,1,1,1,1
13,1,1,1,1,1,0,0,0,0,0,1,0,0,0,0,0,1,1,0,0,0,0,0,0,0,0,0,2,2,1,1,1,1,1,2,1,1,1,0,0
14,1,1,1,1,1,1,0,0,0,0,0,0,0,0,0,0,0,0,0,0,0,0,1,0,0,1,1,1,1,2,1,1,1,1,2,2,2,1,0,0
15,1,1,1,1,1,1,1,1,0,0,0,0,0,0,0,0,0,0,0,0,0,0,1,1,1,1,1,1,1,1,1,1,0,0,2,1,2,1,1,0
16,1,1,1,1,1,1,1,1,1,1,1,0,0,0,0,1,1,0,0,0,0,2,2,2,2,1,1,1,1,1,0,0,0,0,1,1,1,1,1,1
17,1,1,1,1,1,1,1,1,1,1,1,1,0,0,0,1,1,0,0,0,0,2,2,2,2,2,1,1,1,1,0,0,0,1,1,1,1,1,1,1
18,1,1,1,1,1,1,1,1,1,1,1,0,0,0,0,1,1,0,0,0,1,2,2,2,2,2,1,1,1,1,0,1,1,1,1,1,1,1,1,1
19,1,1,1,1,1,1,1,1,1,1,0,0,0,0,0,1,1,1,1,1,0,2,2,2,2,2,1,1,1,1,1,0,1,1,1,1,1,1,1,1
20,1,1,1,1,1,1,1,1,1,0,0,0,0,0,0,0,1,1,1,0,0,0,0,0,2,1,1,1,1,1,1,0,0,1,1,1,1,1,1,1
21,0,0,0,0,1,1,1,1,1,0,0,1,1,0,0,0,1,1,1,0,0,0,0,0,1,1,1,1,1,1,1,0,0,1,1,1,1,0,0,0
22,0,0,0,0,1,1,1,1,1,1,1,1,1,0,0,0,0,0,0,0,0,0,0,0,1,1,1,1,1,1,1,0,1,1,1,1,1,0,0,0
23,0,0,0,1,1,1,1,1,1,1,1,1,1,0,0,0,0,0,0,0,0,0,0,0,1,1,1,1,1,1,1,0,0,1,1,1,1,1,0,0
24,0,0,0,0,1,1,1,1,1,0,0,0,1,1,0,0,0,0,0,0,0,0,0,1,1,1,1,1,1,1,0,0,0,1,1,1,1,1,0,0
25,0,0,0,0,0,1,1,1,1,0,0,0,1,1,1,0,0,0,0,0,0,1,1,2,2,1,0,0,0,0,0,0,0,0,0,0,0,0,0,0
26,0,0,0,0,0,1,1,1,1,1,0,1,1,1,1,1,1,1,0,0,0,1,1,2,2,1,0,0,0,0,0,0,0,0,0,0,0,0,0,0
27,0,0,0,0,1,1,1,1,1,1,1,1,1,1,1,1,2,1,0,0,0,1,1,1,1,2,1,0,0,0,0,0,0,0,0,0,0,0,0,0
28,0,0,0,0,1,1,1,1,1,1,1,1,1,1,1,1,1,1,1,1,1,1,1,1,1,1,1,1,0,0,0,0,0,0,0,0,1,1,1,1
29,0,0,1,1,1,1,1,1,1,1,1,1,1,1,1,1,1,1,1,1,1,1,1,1,1,1,1,0,0,0,0,0,0,0,0,0,0,1,1,1
30,0,0,1,1,1,1,1,1,1,1,1,1,1,1,2,1,1,1,1,1,1,1,1,1,1,0,0,0,0,1,1,1,1,1,0,0,0,1,1,1
31,0,0,0,1,1,1,1,0,0,1,1,1,1,1,1,1,1,1,1,1,1,1,1,1,1,1,0,0,0,1,1,1,1,1,0,0,0,2,2,1
32,0,0,1,1,1,1,0,0,0,0,1,1,1,1,1,1,1,1,1,1,1,1,1,1,0,0,0,0,0,0,1,1,1,1,0,0,0,2,2,1
33,0,1,1,1,1,1,0,0,0,0,0,0,0,0,0,1,1,1,1,1,1,1,1,0,0,0,0,0,0,0,1,1,1,0,0,0,0,1,2,1
34,1,1,1,1,1,1,0,0,0,0,0,0,0,0,0,0,1,1,1,1,1,1,1,0,0,0,0,0,0,0,0,1,0,0,0,0,1,1,1,1
35,1,1,1,1,1,1,1,1,1,1,0,0,1,0,0,0,1,1,1,1,1,1,1,0,0,0,0,0,0,1,1,1,0,0,0,0,1,1,1,1
36,1,1,1,1,1,1,1,1,1,1,1,1,1,1,1,1,0,1,1,1,1,1,0,0,0,2,2,0,2,1,1,1,0,0,0,0,0,1,1,1
37,1,1,1,1,1,1,1,1,1,1,1,1,1,1,1,1,0,1,1,1,1,0,0,0,2,2,2,2,1,1,1,1,0,0,0,0,0,0,0,1
38,1,1,1,1,1,1,1,1,1,0,0,1,1,1,1,1,0,0,1,1,0,0,0,0,2,2,2,2,1,1,1,1,0,0,0,0,0,0,0,0
39,1,1,1,1,1,1,1,1,1,0,0,0,1,1,1,0,0,0,0,1,0,0,0,0,1,2,1,1,1,1,1,1,0,0,0,0,0,0,0,0
