,0,1,2,3,4,5,6,7,8,9,10,11,12,13,14,15,16,17,18,19,20,21,22,23,24,25,26,27,28,29,30,31,32,33,34,35,36,37,38,39
0,0,0,0,0,1,0,0,0,0,1,1,1,1,1,1,1,1,0,0,0,0,0,0,0,0,0,0,0,0,0,1,1,1,1,1,1,1,1,1,1
1,0,0,0,1,1,1,0,0,1,1,1,1,1,1,1,1,1,0,0,0,0,0,0,0,0,0,0,0,0,0,1,1,2,1,1,1,1,1,1,1
2,0,1,1,1,1,1,1,1,1,1,1,1,1,1,1,1,1,1,0,0,0,0,0,0,0,0,0,0,0,0,1,1,2,2,2,1,1,1,1,1
3,1,1,1,1,1,1,1,1,1,1,1,1,1,1,1,1,1,1,0,0,0,0,0,0,0,0,0,0,0,0,1,1,2,1,1,1,1,1,1,1
4,1,1,1,1,1,1,1,1,1,1,1,1,1,1,1,1,1,1,1,0,0,0,0,0,2,2,2,2,0,0,0,0,0,0,0,0,1,1,1,0
5,1,1,1,1,1,1,1,1,1,1,1,1,1,1,1,1,1,1,1,1,0,0,0,1,2,2,2,2,2,2,0,0,0,0,0,0,0,0,0,0
6,1,1,1,1,1,1,1,1,1,1,1,1,1,1,1,1,1,1,1,1,1,1,1,2,2,2,2,2,2,2,2,0,0,0,0,0,0,0,0,0
7,1,1,1,1,1,1,1,1,1,1,1,1,1,1,1,1,1,1,1,1,1,1,1,2,2,2,2,2,2,2,2,2,0,2,0,0,0,0,0,0
8,1,1,1,1,1,1,1,1,1,1,1,1,1,1,1,1,1,1,1,1,1,1,1,2,2,2,2,2,2,2,2,2,2,2,2,2,2,0,0,0
9,1,1,1,1,1,1,1,1,1,1,1,1,1,1,1,1,2,2,1,1,1,1,1,1,2,2,2,2,2,2,2,2,2,2,2,2,2,2,2,2
10,1,1,1,1,1,1,1,1,1,1,1,1,1,1,1,1,2,2,2,1,1,1,1,1,2,2,2,2,2,2,2,2,2,2,2,2,2,2,2,2
11,1,1,1,1,1,2,2,2,2,1,1,1,1,1,1,1,1,2,2,1,1,1,1,1,2,2,2,2,2,2,2,2,2,2,2,2,2,2,2,2
12,1,1,1,2,2,2,2,2,2,2,2,2,2,2,1,1,1,1,1,1,1,1,1,1,2,2,2,2,2,2,2,2,2,2,2,2,2,2,2,2
13,1,1,1,2,2,2,2,2,2,2,2,2,2,2,2,1,1,1,1,1,1,1,1,1,1,2,2,2,2,2,2,2,2,2,2,2,2,2,2,2
14,1,1,1,0,0,2,2,2,2,2,2,2,2,2,2,2,1,1,1,1,1,1,0,0,1,1,1,1,2,2,2,2,2,2,2,2,0,0,2,2
15,1,1,0,0,0,2,2,2,2,2,2,2,2,2,2,2,1,1,1,1,1,0,0,0,0,1,1,2,2,2,2,2,2,2,2,0,0,0,0,0
16,1,1,1,0,0,2,2,2,2,2,2,2,2,2,2,2,2,2,1,1,1,1,2,0,0,2,2,2,2,2,2,2,2,2,2,0,0,0,0,0
17,1,1,1,0,2,2,2,2,2,2,2,2,2,2,2,2,2,0,1,1,1,1,2,2,2,2,0,0,0,2,2,2,2,2,2,2,0,0,0,0
18,0,0,0,0,2,2,2,2,2,2,2,2,2,2,2,2,0,0,0,1,1,1,2,2,2,2,0,0,0,2,2,2,2,2,2,2,0,0,0,2
19,0,0,0,0,2,2,2,2,2,2,2,2,2,2,2,0,0,0,0,1,1,2,2,2,2,2,2,0,2,2,2,2,2,2,2,2,2,0,0,2
20,0,0,0,0,2,2,2,2,2,2,2,2,2,2,2,2,2,0,0,2,2,2,2,2,2,2,2,2,2,2,2,2,2,2,2,2,2,0,0,2
21,0,0,2,2,2,2,2,2,2,2,2,2,2,2,2,2,2,0,0,0,2,2,2,2,2,2,2,2,2,2,2,2,2,2,2,2,2,2,2,2
22,0,0,2,2,2,0,0,0,0,2,2,2,2,2,2,2,2,0,0,0,2,2,2,2,2,2,2,2,2,2,2,2,2,2,2,2,2,2,2,2
23,1,2,2,2,0,0,0,0,0,0,2,2,2,2,2,2,2,0,0,2,2,2,2,2,2,2,2,2,2,2,2,2,2,2,2,2,2,2,2,2
24,2,2,2,2,0,2,2,0,0,0,0,2,2,2,2,2,2,2,2,2,2,2,2,2,2,2,2,2,2,2,2,2,2,2,2,2,2,2,2,2
25,2,2,2,2,2,2,2,0,0,0,0,0,2,2,2,2,2,2,2,2,2,2,2,2,2,2,2,2,2,2,2,2,2,2,2,2,2,2,2,2
26,2,2,2,2,2,2,2,2,0,0,0,0,2,2,2,2,2,2,2,2,2,2,2,2,2,2,2,2,2,2,2,2,2,2,2,2,2,2,2,0
27,0,2,2,2,2,2,2,2,0,0,0,0,0,2,2,2,2,2,2,2,2,2,2,2,2,2,2,2,2,2,2,2,2,2,2,2,0,2,0,0
28,0,0,2,2,2,2,2,2,0,0,0,0,0,0,0,0,2,2,2,2,2,2,2,2,2,2,2,2,2,2,2,2,2,2,2,2,0,0,0,0
29,0,0,2,2,2,2,2,2,2,2,2,1,1,0,0,0,2,2,2,2,2,2,2,2,2,2,2,2,2,2,2,2,2,2,2,0,0,0,0,0
30,2,2,2,2,2,2,2,2,2,2,1,1,1,0,0,0,0,0,2,2,2,2,2,2,2,2,2,2,2,2,2,2,2,2,2,0,0,0,0,0
31,2,2,2,2,2,2,2,2,2,2,2,1,2,2,0,0,0,0,0,0,0,2,2,1,2,0,0,0,2,2,2,2,2,2,2,2,2,2,2,0
32,2,2,2,2,2,2,2,2,2,2,2,2,2,2,2,0,0,0,0,0,0,2,1,1,1,0,0,0,2,2,2,2,2,2,2,2,2,2,2,0
33,2,2,2,2,0,0,2,0,0,0,2,2,2,2,2,0,0,0,0,0,0,2,2,1,1,0,0,0,2,0,0,2,2,2,2,2,2,2,2,0
34,2,2,2,2,0,0,0,0,0,0,2,2,2,2,2,0,0,0,2,2,2,2,2,1,0,0,0,0,0,0,0,0,2,2,2,2,2,2,2,2
35,2,2,2,0,0,0,0,0,0,0,2,2,2,2,2,2,0,0,2,2,2,2,2,1,0,0,0,0,0,0,0,0,2,2,2,2,2,2,2,2
36,2,2,0,0,0,0,0,0,0,0,2,2,2,2,2,2,2,2,2,2,2,2,0,0,0,0,0,0,0,0,0,0,2,2,2,2,2,0,0,2
37,2,2,0,0,0,0,0,0,0,0,2,2,2,2,2,2,2,2,2,2,2,0,0,0,0,0,0,0,0,0,0,2,2,2,2,2,2,0,0,0
38,2,2,0,0,0,0,1,1,1,1,2,2,2,2,2,2,2,2,2,2,0,0,0,0,0,0,0,0,0,0,2,2,2,2,2,2,2,0,0,0
39,2,2,0,0,0,0,1,1,1,1,2,2,2,2,2,2,2,2,2,2,0,0,0,0,0,0,0,0,0,2,2,2,2,2,2,2,2,0,0,0
