,0,1,2,3,4,5,6,7,8,9,10,11,12,13,14,15,16,17,18,19
0,0,0,0,0,0,0,0,0,1,1,1,1,1,1,1,1,1,1,1,1
1,0,0,0,0,0,0,0,0,1,1,1,1,1,1,1,1,1,1,1,1
2,0,0,0,0,0,0,0,1,1,1,1,1,1,1,1,1,1,1,1,1
3,0,0,0,0,0,0,0,0,1,1,1,1,1,1,1,1,1,1,1,1
4,0,0,0,0,0,0,0,0,1,1,1,1,1,1,2,1,2,1,1,1
5,0,0,0,0,0,0,0,0,1,2,2,2,1,1,1,2,1,1,1,1
6,1,1,0,0,0,0,0,0,0,0,2,2,2,1,0,1,1,1,1,1
7,1,2,0,2,2,0,0,0,0,2,2,2,2,0,0,0,1,1,1,1
8,1,2,2,2,2,0,0,0,2,2,2,2,0,0,0,0,0,0,1,1
9,2,2,2,2,2,2,0,0,2,2,2,2,0,0,0,0,0,0,1,1
10,2,2,2,2,2,2,0,2,2,2,2,0,0,0,0,0,0,0,0,0
11,2,2,2,2,2,2,2,2,2,2,2,2,0,0,0,0,0,0,0,0
12,2,2,2,2,2,2,2,2,0,2,2,2,2,2,0,0,0,0,0,0
13,1,2,2,2,0,0,0,0,0,0,2,2,2,0,0,0,0,0,0,0
14,1,2,2,2,2,0,0,1,0,0,2,2,2,1,0,0,0,0,0,0
15,1,2,2,2,1,1,1,1,1,2,2,2,2,1,1,0,0,0,0,0
16,1,1,2,1,1,1,1,1,1,1,1,1,1,1,1,0,0,0,0,0
17,2,2,1,1,1,1,1,1,2,2,1,1,1,1,1,1,1,0,0,0
18,2,2,2,1,1,1,1,1,2,2,2,2,1,1,1,1,1,2,2,2
19,2,2,1,1,1,1,2,1,2,2,2,2,1,1,1,1,2,2,2,2
