,0,1,2,3,4,5,6,7,8,9,10,11,12,13,14,15,16,17,18,19,20,21,22,23,24,25,26,27,28,29,30,31,32,33,34,35,36,37,38,39
0,0,0,0,0,0,0,0,1,1,1,1,1,1,0,2,2,2,2,0,0,0,0,2,2,2,2,1,1,1,1,1,1,1,1,1,0,0,0,0,1
1,0,0,0,0,0,0,1,1,1,1,1,1,1,0,0,2,2,2,0,0,0,2,2,2,2,2,1,1,1,1,1,1,1,1,1,0,0,1,1,1
2,0,0,0,0,0,1,1,1,1,1,2,1,2,0,0,0,0,2,0,0,2,2,2,2,2,2,1,1,1,1,1,1,1,1,1,1,1,1,1,1
3,1,0,0,0,0,0,2,2,2,1,1,2,2,0,0,0,0,0,2,2,2,2,2,2,2,2,1,1,1,1,1,1,1,1,1,1,1,1,1,1
4,1,1,0,0,0,0,0,2,2,1,1,2,2,0,0,0,0,0,2,2,2,2,2,2,2,0,1,1,1,1,1,1,1,1,1,1,1,1,1,1
5,1,1,0,0,0,0,0,0,2,1,1,1,1,1,0,0,0,2,2,2,2,2,2,2,2,0,0,1,1,1,0,0,0,2,2,2,2,2,2,1
6,1,1,1,0,0,0,1,1,1,1,1,1,1,1,1,1,0,0,2,2,2,2,2,2,2,0,0,1,1,0,0,0,0,2,2,2,2,2,0,0
7,1,1,1,1,1,1,1,1,1,2,1,1,1,1,1,1,0,0,0,2,2,2,2,2,2,2,1,0,0,0,0,0,0,2,2,2,2,2,0,0
8,1,1,1,1,0,1,1,1,1,1,1,1,1,1,1,1,0,0,0,0,2,2,2,2,2,1,1,0,0,0,0,0,0,2,2,2,2,2,2,0
9,1,1,1,0,0,0,1,1,1,1,2,2,1,1,1,1,0,0,0,0,2,2,2,2,2,1,1,2,0,0,0,0,0,0,2,2,2,2,2,2
10,1,1,1,0,0,0,1,1,1,2,2,2,1,1,1,0,0,0,0,0,0,2,2,1,1,1,1,1,2,0,0,2,0,0,0,2,2,2,2,2
11,1,1,1,0,0,0,0,1,1,1,2,2,1,1,0,0,0,0,0,0,0,0,1,1,1,1,1,1,0,0,2,2,0,0,0,2,2,2,2,2
12,1,1,1,0,0,0,0,1,1,2,2,2,1,1,0,0,0,0,0,0,0,0,0,0,0,1,1,0,0,0,2,2,2,0,2,2,2,2,2,2
13,1,1,1,1,1,1,1,1,1,2,2,0,1,0,0,0,0,0,0,0,0,0,0,0,0,0,0,0,0,0,2,2,2,2,2,2,2,2,2,2
14,1,1,1,1,1,1,1,1,1,2,0,0,0,0,0,0,0,0,0,0,0,0,0,0,0,0,2,0,0,0,2,2,2,2,2,2,2,2,2,2
15,1,1,1,1,1,1,1,1,1,1,0,0,0,0,0,1,1,1,0,0,0,0,0,0,0,2,2,2,2,2,2,2,2,2,2,2,2,2,2,2
16,1,1,1,1,1,1,1,1,1,1,1,0,0,0,0,1,1,1,0,0,0,0,0,0,0,2,2,2,2,2,2,2,2,2,2,2,2,2,2,2
17,1,1,1,1,1,0,0,1,1,1,1,0,0,0,0,1,1,0,0,0,0,1,1,0,0,2,2,2,2,2,2,2,2,2,2,2,2,2,2,2
18,1,1,1,1,1,0,0,0,1,1,0,0,0,0,0,0,0,0,0,0,0,1,1,0,0,0,2,2,2,2,2,2,2,2,2,2,2,2,2,2
19,1,1,1,0,0,0,0,0,0,0,1,1,0,0,0,0,0,0,0,0,1,1,1,0,0,0,2,2,2,2,2,2,2,0,0,2,2,2,2,2
20,0,1,0,0,0,0,0,0,0,0,1,1,1,0,0,0,0,0,0,0,0,1,2,2,2,2,2,2,2,2,2,2,2,2,0,0,0,2,2,2
21,0,0,0,0,0,0,0,0,0,0,1,1,1,0,0,0,0,0,0,0,0,1,1,2,2,2,2,2,2,2,2,2,2,2,0,0,0,0,2,2
22,0,0,0,0,0,0,0,0,0,0,1,2,1,0,0,0,0,0,0,0,0,1,0,0,2,2,2,2,2,2,2,2,2,2,1,0,0,0,0,0
23,0,0,0,0,0,0,0,0,0,0,0,0,0,0,0,0,0,0,0,1,1,0,0,0,2,2,2,2,2,2,2,1,1,1,1,0,0,0,0,0
24,0,0,0,0,2,2,2,0,0,0,0,0,0,0,0,0,0,0,1,1,1,1,0,0,0,2,2,2,2,2,0,1,1,1,0,0,0,0,0,0
25,0,0,0,2,2,2,2,0,0,0,0,0,0,0,0,0,0,2,1,1,1,1,0,0,0,0,2,2,2,0,0,1,1,1,0,0,0,0,0,0
26,0,0,0,0,2,2,2,0,0,0,0,0,0,0,2,2,2,2,2,1,1,1,1,0,0,0,0,2,0,0,0,0,1,0,0,0,0,0,0,0
27,0,0,0,0,2,2,0,0,0,0,0,0,0,0,2,2,2,2,2,1,1,1,2,2,0,0,0,1,1,0,0,0,0,0,0,0,0,0,0,0
28,0,0,0,0,0,0,0,0,0,0,0,0,2,2,2,2,2,2,2,1,1,1,2,2,0,0,0,1,0,0,0,0,0,0,0,0,0,0,0,0
29,0,0,0,0,0,0,0,0,0,0,0,2,2,2,2,2,2,0,0,0,0,1,2,2,0,0,0,0,0,0,0,0,0,0,0,0,0,0,1,1
30,0,0,0,0,0,0,0,2,2,0,0,2,2,2,2,0,0,0,0,0,0,0,1,1,0,0,0,0,0,2,2,0,0,0,0,0,0,1,1,1
31,0,0,0,0,0,0,0,2,2,2,2,2,2,2,0,0,0,0,0,0,0,0,1,1,1,1,0,0,2,2,2,0,0,0,0,2,2,1,1,1
32,1,1,0,0,0,0,0,2,2,2,2,2,2,2,0,0,0,0,0,0,0,0,1,1,1,1,1,2,2,2,2,0,0,0,0,2,2,1,0,0
33,2,1,1,2,2,0,0,2,2,0,0,2,2,2,2,0,0,0,0,0,0,1,1,1,1,2,1,1,2,1,1,1,0,0,2,0,0,0,0,0
34,2,1,1,2,2,2,0,0,0,0,0,2,2,2,2,2,2,1,2,2,2,2,2,2,2,2,2,2,1,1,1,2,0,2,2,0,0,0,0,0
35,1,1,1,2,2,2,2,2,0,0,0,2,2,2,0,2,2,1,2,2,2,2,2,2,2,2,2,2,1,1,2,2,2,2,2,2,0,0,0,0
36,1,1,1,2,2,2,2,2,2,0,0,0,2,0,0,0,1,1,2,2,2,2,2,2,2,2,2,2,2,1,2,2,2,2,2,2,0,0,0,1
37,1,1,1,1,2,2,2,2,2,1,0,0,0,0,0,0,0,2,2,2,2,2,2,2,2,2,2,2,2,1,2,2,2,2,0,0,0,1,1,1
38,1,1,1,1,2,2,2,2,2,0,0,0,0,0,0,0,1,2,2,2,2,2,2,2,2,2,2,2,2,1,1,2,2,0,0,0,0,1,1,1
39,1,1,1,1,2,2,2,2,2,0,0,0,0,0,0,0,1,2,2,2,2,2,2,2,2,2,2,2,2,1,2,2,2,0,0,0,0,1,1,1
